Rank,Release Group,Worldwide,Domestic,Foreign,Filename,Year,Domestic %,Foreign %
1,Avengers: Endgame,2797800564,858373000,1939427564,2019.csv,2019,30.6802783245132,69.3197216754868
2,Star Wars: Episode VII - The Force Awakens,2068223624,936662225,1131561399,2015.csv,2015,45.28824707980417,54.711752920195835
3,Avengers: Infinity War,2048359754,678815482,1369544272,2018.csv,2018,33.13946589091205,66.86053410908795
4,Jurassic World,1670400637,652270625,1018130012,2015.csv,2015,39.04875336802209,60.95124663197791
5,The Lion King,1656943394,543638043,1113305351,2019.csv,2019,32.809693135479556,67.19030686452044
6,The Avengers,1518812988,623357910,895455078,2012.csv,2012,41.04244004529147,58.95755995470853
7,Furious 7,1515047671,353007020,1162040651,2015.csv,2015,23.30006023949064,76.69993976050937
8,Frozen II,1450026933,477373578,972653355,2019.csv,2019,32.9217042205105,67.0782957794895
9,Avengers: Age of Ultron,1402805868,459005868,943800000,2015.csv,2015,32.72055517235689,67.2794448276431
10,Black Panther,1346913161,700059566,646853595,2018.csv,2018,51.97510769589992,48.02489230410007
11,Harry Potter and the Deathly Hallows: Part 2,1341511219,381011219,960500000,2011.csv,2011,28.40164238686102,71.59835761313897
12,Star Wars: Episode VIII - The Last Jedi,1332539889,620181382,712358507,2017.csv,2017,46.5412995978239,53.458700402176106
13,Jurassic World: Fallen Kingdom,1308467944,417719760,890748184,2018.csv,2018,31.924340364275672,68.07565963572432
14,Frozen,1280802282,400738009,880064273,2013.csv,2013,31.288046143565506,68.71195385643449
15,Beauty and the Beast,1263521126,504014165,759506961,2017.csv,2017,39.88965080430321,60.11034919569679
16,Incredibles 2,1242805359,608581744,634223615,2018.csv,2018,48.9683874946986,51.0316125053014
17,The Fate of the Furious,1236005118,226008385,1009996733,2017.csv,2017,18.28539232634472,81.71460767365528
18,Iron Man 3,1214811252,409013994,805797258,2013.csv,2013,33.668933616363965,66.33106638363603
19,Minions,1159398397,336045770,823352627,2015.csv,2015,28.984494964762312,71.01550503523768
20,Captain America: Civil War,1153296293,408084349,745211944,2016.csv,2016,35.384172434862755,64.61582756513724
21,Aquaman,1148461807,335061807,813400000,2018.csv,2018,29.174832367760228,70.82516763223977
22,Spider-Man: Far from Home,1131927996,390532085,741395911,2019.csv,2019,34.5014953583673,65.4985046416327
23,Captain Marvel,1128274794,426829839,701444955,2019.csv,2019,37.83030882811692,62.16969117188308
24,Transformers: Dark of the Moon,1123794079,352390543,771403536,2011.csv,2011,31.357216556397248,68.64278344360275
25,Skyfall,1108561013,304360277,804200736,2012.csv,2012,27.45543758356943,72.54456241643057
26,Transformers: Age of Extinction,1104054072,245439076,858614996,2014.csv,2014,22.230711540729683,77.76928845927031
27,The Dark Knight Rises,1081041287,448139099,632902188,2012.csv,2012,41.45439257399981,58.54560742600019
28,Joker,1074251311,335451311,738800000,2019.csv,2019,31.22652097931673,68.77347902068327
29,Star Wars: Episode IX - The Rise of Skywalker,1074144248,515202542,558941706,2019.csv,2019,47.963999524205434,52.03600047579457
30,Toy Story 4,1073394593,434038008,639356585,2019.csv,2019,40.436015872496576,59.563984127503424
31,Toy Story 3,1066969703,415004880,651964823,2010.csv,2010,38.89565737744289,61.104342622557105
32,Rogue One: A Star Wars Story,1056057273,532177324,523879949,2016.csv,2016,50.392846828109484,49.607153171890516
33,Aladdin,1050693953,355559216,695134737,2019.csv,2019,33.84041708670612,66.15958291329387
34,Pirates of the Caribbean: On Stranger Tides,1045713802,241071802,804642000,2011.csv,2011,23.053325062644625,76.94667493735537
35,Despicable Me 3,1034799409,264624300,770175109,2017.csv,2017,25.57252136969475,74.42747863030525
36,Finding Dory,1028570889,486295561,542275328,2016.csv,2016,47.278759898871684,52.721240101128316
37,Alice in Wonderland,1025467110,334191110,691276000,2010.csv,2010,32.58915929541612,67.41084070458389
38,Zootopia,1023784195,341268248,682515947,2016.csv,2016,33.33400238709487,66.66599761290513
39,The Hobbit: An Unexpected Journey,1017003568,303003568,714000000,2012.csv,2012,29.793756633113404,70.20624336688658
40,Harry Potter and the Deathly Hallows: Part 1,976536918,295983305,680553613,2010.csv,2010,30.309484418283915,69.69051558171608
41,Despicable Me 2,970766005,368065385,602700620,2013.csv,2013,37.914943776796136,62.085056223203864
42,The Jungle Book,966550600,364001123,602549477,2016.csv,2016,37.65981036067848,62.34018963932152
43,Jumanji: Welcome to the Jungle,962077546,404515480,557562066,2017.csv,2017,42.04603690023133,57.95396309976868
44,The Hobbit: The Desolation of Smaug,958366855,258366855,700000000,2013.csv,2013,26.95907664711547,73.04092335288452
45,The Hobbit: The Battle of the Five Armies,956019788,255119788,700900000,2014.csv,2014,26.685617934092388,73.31438206590761
46,Bohemian Rhapsody,903655259,216428042,687227217,2018.csv,2018,23.950288546929155,76.04971145307084
47,Spectre,880674609,200074609,680600000,2015.csv,2015,22.718335121207065,77.28166487879294
48,Spider-Man: Homecoming,880166924,334201140,545965784,2017.csv,2017,37.9701998435924,62.0298001564076
49,Ice Age: Continental Drift,877244782,161321843,715922939,2012.csv,2012,18.389604168657225,81.61039583134277
50,The Secret Life of Pets,875457937,368384330,507073607,2016.csv,2016,42.07904394154804,57.92095605845196
51,Batman v Superman: Dawn of Justice,873634919,330360194,543274725,2016.csv,2016,37.81444477724682,62.18555522275317
52,Wolf Warrior 2,870325439,2721100,867604339,2017.csv,2017,0.3126531614572282,99.68734683854277
53,The Hunger Games: Catching Fire,865011746,424668047,440343699,2013.csv,2013,49.0939052520103,50.90609474798969
54,Guardians of the Galaxy Vol. 2,863756051,389813101,473942950,2017.csv,2017,45.12999944240043,54.87000055759956
55,Inside Out,857611174,356461711,501149463,2015.csv,2015,41.56449004009829,58.43550995990171
56,Venom,856085151,213515506,642569645,2018.csv,2018,24.94091922405041,75.05908077594958
57,Thor: Ragnarok,853977126,315058289,538918837,2017.csv,2017,36.893059475225336,63.10694052477467
58,The Twilight Saga: Breaking Dawn - Part 2,829746820,292324737,537422083,2012.csv,2012,35.23059443602327,64.76940556397673
59,Inception,826137188,292576195,533560993,2010.csv,2010,35.41496488111125,64.58503511888875
60,Wonder Woman,821847012,412563408,409283604,2017.csv,2017,50.199538597336904,49.8004614026631
61,Fantastic Beasts and Where to Find Them,814037575,234037575,580000000,2016.csv,2016,28.750217703402697,71.2497822965973
62,Coco,807816196,210460015,597356181,2017.csv,2017,26.052958091471588,73.9470419085284
63,Jumanji: The Next Level,800059707,320314960,479744747,2019.csv,2019,40.03638193467978,59.96361806532021
64,Pirates of the Caribbean: Dead Men Tell No Tales,794861794,172558876,622302918,2017.csv,2017,21.709293024593403,78.2907069754066
65,Mission: Impossible - Fallout,791115104,220159104,570956000,2018.csv,2018,27.828959766643514,72.17104023335649
66,Fast & Furious 6,788679850,238679850,550000000,2013.csv,2013,30.263211365169273,69.73678863483073
67,Deadpool,782612155,363070709,419541446,2016.csv,2016,46.392163305973696,53.607836694026304
68,Guardians of the Galaxy,772776600,333176600,439600000,2014.csv,2014,43.11421955581988,56.885780444180114
69,Fast & Furious Presents: Hobbs & Shaw,759056935,173956935,585100000,2019.csv,2019,22.917508157671993,77.08249184232801
70,Maleficent,758410378,241410378,517000000,2014.csv,2014,31.831101604466706,68.16889839553329
71,The Amazing Spider-Man,757930663,262030663,495900000,2012.csv,2012,34.57185146235467,65.42814853764533
72,The Hunger Games: Mockingjay - Part 1,755356711,337135885,418220826,2014.csv,2014,44.632672231596814,55.367327768403186
73,Shrek Forever After,752600867,238736787,513864080,2010.csv,2010,31.721566831519475,68.27843316848052
74,Madagascar 3: Europe's Most Wanted,746921274,216391482,530529792,2012.csv,2012,28.971123133386612,71.02887686661339
75,Suicide Squad,746846894,325100054,421746840,2016.csv,2016,43.52967878848808,56.47032121151193
76,X-Men: Days of Future Past,746045700,233921534,512124166,2014.csv,2014,31.35485319465014,68.64514680534985
77,Monsters University,743559607,268492764,475066843,2013.csv,2013,36.10911102114238,63.89088897885762
78,Deadpool 2,734546611,318491426,416055185,2018.csv,2018,43.35891299891927,56.64108700108073
79,Ne Zha,726063471,3695533,722367938,2019.csv,2019,0.5089820859476899,99.49101791405232
80,Gravity,723192705,274092705,449100000,2013.csv,2013,37.90036916923823,62.09963083076177
81,Captain America: The Winter Soldier,714421503,259766572,454654931,2014.csv,2014,36.360407813760894,63.63959218623911
82,The Twilight Saga: Breaking Dawn - Part 1,712205856,281287133,430918723,2011.csv,2011,39.4952008089077,60.5047991910923
83,Dawn of the Planet of the Apes,710644566,208545589,502098977,2014.csv,2014,29.345976734028806,70.65402326597119
84,The Amazing Spider-Man 2,708982323,202853933,506128390,2014.csv,2014,28.611987410580337,71.38801258941967
85,It,700381748,327481748,372900000,2017.csv,2017,46.757607395559944,53.242392604440056
86,The Wandering Earth,699856699,5971413,693885286,2019.csv,2019,0.8532336703402763,99.14676632965971
87,The Twilight Saga: Eclipse,698491347,300531751,397959596,2010.csv,2010,43.02583736946422,56.97416263053579
88,Mission: Impossible - Ghost Protocol,694713380,209397903,485315477,2011.csv,2011,30.141625169217267,69.85837483078274
89,The Hunger Games,694394724,408010692,286384032,2012.csv,2012,58.757746552233314,41.24225344776669
90,Mission: Impossible - Rogue Nation,682714267,195042377,487671890,2015.csv,2015,28.56866868434727,71.43133131565274
91,Interstellar,677896797,188020017,489876780,2014.csv,2014,27.735787782457983,72.26421221754201
92,Doctor Strange,677718395,232641920,445076475,2016.csv,2016,34.32722524817996,65.67277475182004
93,Man of Steel,668045518,291045518,377000000,2013.csv,2013,43.56671965577052,56.43328034422947
94,Kung Fu Panda 2,665692281,165249063,500443218,2011.csv,2011,24.823641150196842,75.17635884980317
95,The Hunger Games: Mockingjay - Part 2,658344137,281723902,376620235,2015.csv,2015,42.792801844303504,57.207198155696496
96,Justice League,657924295,229024295,428900000,2017.csv,2017,34.81012887660578,65.18987112339421
97,Big Hero 6,657827828,222527828,435300000,2014.csv,2014,33.827670178769026,66.17232982123097
98,Fantastic Beasts: The Crimes of Grindelwald,654855901,159555901,495300000,2018.csv,2018,24.365039813545177,75.63496018645482
99,Thor: The Dark World,644783140,206362140,438421000,2013.csv,2013,32.004890822672564,67.99510917732744
100,Moana,643331111,248757044,394574067,2016.csv,2016,38.667031602642325,61.33296839735767
101,Sing,634151679,270395425,363756254,2016.csv,2016,42.63891967082532,57.36108032917468
102,The Martian,630161890,228433663,401728227,2015.csv,2015,36.24999648899745,63.750003511002554
103,Fast Five,626137675,209837675,416300000,2011.csv,2011,33.51302491101498,66.48697508898502
104,Men in Black 3,624026776,179020854,445005922,2012.csv,2012,28.68800841328001,71.31199158672
105,Iron Man 2,623933331,312433331,311500000,2010.csv,2010,50.07479412892594,49.92520587107407
106,Ant-Man and the Wasp,622674139,216648740,406025399,2018.csv,2018,34.79327732285988,65.20672267714012
107,How to Train Your Dragon 2,621537519,177002924,444534595,2014.csv,2014,28.478236403939437,71.52176359606057
108,Logan,619021436,226277068,392744368,2017.csv,2017,36.55399552270109,63.446004477298914
109,Life of Pi,609016565,124987023,484029542,2012.csv,2012,20.522762463776335,79.47723753622367
110,Transformers: The Last Knight,605425157,130168683,475256474,2017.csv,2017,21.500375644284635,78.49962435571537
111,Tangled,592461732,200821936,391639796,2010.csv,2010,33.89618690173899,66.103813098261
112,The Croods,587204668,187168425,400036243,2013.csv,2013,31.874478388853678,68.12552161114633
113,The Hangover Part II,586764305,254464305,332300000,2011.csv,2011,43.367379854505636,56.632620145494364
114,Ready Player One,582890172,137690172,445200000,2018.csv,2018,23.62197522177471,76.37802477822528
115,Operation Red Sea,579330426,1543547,577786879,2018.csv,2018,0.2664363773636843,99.73356362263631
116,Fifty Shades of Grey,569651467,166167230,403484237,2015.csv,2015,29.16998193212763,70.83001806787237
117,Kong: Skull Island,566652812,168052812,398600000,2017.csv,2017,29.657103686975084,70.34289631302492
118,The Smurfs,563749323,142614158,421135165,2011.csv,2011,25.297441997992433,74.70255800200756
119,Cars 2,559852396,191452396,368400000,2011.csv,2011,34.196941438114344,65.80305856188566
120,Puss in Boots,554987477,149260504,405726973,2011.csv,2011,26.894391348581724,73.10560865141828
121,The Mermaid,553810228,3232685,550577543,2016.csv,2016,0.5837170995693493,99.41628290043066
122,Ted,549368315,218815487,330552828,2012.csv,2012,39.8303799155217,60.16962008447829
123,American Sniper,547426372,350126372,197300000,2014.csv,2014,63.9586234621521,36.04137653784791
124,Detective Chinatown 2,544185156,1983984,542201172,2018.csv,2018,0.36457885301083076,99.63542114698917
125,X-Men: Apocalypse,543934105,155442489,388491616,2016.csv,2016,28.577448549581202,71.4225514504188
126,Sherlock Holmes: A Game of Shadows,543848418,186848418,357000000,2011.csv,2011,34.35670893134785,65.64329106865215
127,Despicable Me,543113985,251513985,291600000,2010.csv,2010,46.30961307321151,53.69038692678849
128,Cinderella,542351353,201151353,341200000,2015.csv,2015,37.08875286976559,62.911247130234415
129,World War Z,540007876,202359711,337648165,2013.csv,2013,37.473473997997765,62.526526002002235
130,Brave,538983207,237283207,301700000,2012.csv,2012,44.024230053609074,55.975769946390926
131,The Revenant,532950503,183637894,349312609,2015.csv,2015,34.45683848055211,65.54316151944789
132,The Meg,530243742,145443742,384800000,2018.csv,2018,27.42960085703378,72.57039914296621
133,Ralph Breaks the Internet,529323962,201091711,328232251,2018.csv,2018,37.99029052835511,62.00970947164489
134,Hotel Transylvania 3: Summer Vacation,528583774,167510016,361073758,2018.csv,2018,31.690343941583045,68.30965605841696
135,The Boss Baby,527965936,175003033,352962903,2017.csv,2017,33.1466522870521,66.85334771294791
136,Dunkirk,525245546,188045546,337200000,2017.csv,2017,35.80145465907482,64.19854534092518
137,Godzilla,524976069,200676069,324300000,2014.csv,2014,38.225755582013015,61.77424441798699
138,How to Train Your Dragon: The Hidden World,521799505,160799505,361000000,2019.csv,2019,30.81633912243746,69.18366087756255
139,Kung Fu Panda 3,521170825,143528619,377642206,2016.csv,2016,27.539649595696382,72.46035040430363
140,Ant-Man,519311965,180202163,339109802,2015.csv,2015,34.70017545234106,65.29982454765893
141,Dr. Seuss' the Grinch,511595957,270620950,240975007,2018.csv,2018,52.89739809261237,47.10260190738763
142,Rio 2,498781117,131538435,367242682,2014.csv,2014,26.37197570572825,73.62802429427175
143,How to Train Your Dragon,494878759,217581231,277297528,2010.csv,2010,43.96657303289107,56.03342696710892
144,Oz the Great and Powerful,493311825,234911825,258400000,2013.csv,2013,47.619337930932424,52.380662069067576
145,Clash of the Titans,493214993,163214888,330000105,2010.csv,2010,33.092037005452504,66.90796299454749
146,Maleficent: Mistress of Evil,491730089,113929605,377800484,2019.csv,2019,23.169134358178354,76.83086564182165
147,War for the Planet of the Apes,490719763,146880162,343839601,2017.csv,2017,29.931576650194952,70.06842334980506
148,Teenage Mutant Ninja Turtles,485004754,191204754,293800000,2014.csv,2014,39.42327418918454,60.57672581081546
149,Rio,483866518,143619809,340246709,2011.csv,2011,29.681700150205476,70.31829984979453
150,Rise of the Planet of the Apes,481800873,176760185,305040688,2011.csv,2011,36.68739408863628,63.31260591136372
151,Hotel Transylvania 2,474800000,169700110,305099890,2015.csv,2015,35.74138795282224,64.25861204717775
152,San Andreas,473990832,155190832,318800000,2015.csv,2015,32.74131513159732,67.25868486840268
153,It Chapter Two,473093228,211593228,261500000,2019.csv,2019,44.725482310222375,55.274517689777625
154,Wreck-It Ralph,471222889,189422889,281800000,2012.csv,2012,40.198151113156136,59.801848886843864
155,The Lego Movie,468060692,257760692,210300000,2014.csv,2014,55.069929264643314,44.930070735356686
156,Bumblebee,467989645,127195589,340794056,2018.csv,2018,27.17914602576303,72.82085397423698
157,Star Trek Into Darkness,467365246,228778661,238586585,2013.csv,2013,48.95072172311246,51.049278276887534
158,The Eight Hundred,461132912,372755,460760157,2020.csv,2020,0.08083461195239952,99.9191653880476
159,Lucy,458863600,126663600,332200000,2014.csv,2014,27.603758502526677,72.39624149747333
160,Thor,449326618,181030624,268295994,2011.csv,2011,40.289316668081305,59.7106833319187
161,La La Land,447407695,151101803,296305892,2016.csv,2016,33.77273227274287,66.22726772725713
162,Les Misérables,441809770,148809770,293000000,2012.csv,2012,33.681864934765926,66.31813506523407
163,Terminator Genisys,440603537,89760956,350842581,2015.csv,2015,20.372273134974854,79.62772686502514
164,Warcraft,439048914,47365290,391683624,2016.csv,2016,10.788157877097039,89.21184212290297
165,A Star Is Born,436188866,215288866,220900000,2018.csv,2018,49.35679995096436,50.64320004903564
166,The Greatest Showman,434993183,174340174,260653009,2017.csv,2017,40.078829005465124,59.921170994534876
167,Pokémon Detective Pikachu,433005346,144105346,288900000,2019.csv,2019,33.28026947731957,66.71973052268044
168,The Secret Life of Pets 2,430051293,158874395,271176898,2019.csv,2019,36.943126921374,63.056873078626
169,Rampage,428028233,101028233,327000000,2018.csv,2018,23.60317035441912,76.39682964558088
170,The Intouchables,426588510,10198820,416389690,2011.csv,2011,2.3907863810021515,97.60921361899784
171,Bad Boys for Life,426505244,206305244,220200000,2020.csv,2020,48.37109200936343,51.62890799063658
172,Django Unchained,425368238,162805434,262562804,2012.csv,2012,38.27399872766241,61.72600127233759
173,The King's Speech,423999102,135453143,288545959,2010.csv,2010,31.94656365097679,68.05343634902322
174,The Captain,416953262,706572,416246690,2019.csv,2019,0.1694607200362903,99.83053927996372
175,The Chronicles of Narnia: The Voyage of the Dawn Treader,415686217,104386950,311299267,2010.csv,2010,25.111958427045945,74.88804157295405
176,Jason Bourne,415484914,162434410,253050504,2016.csv,2016,39.09514028709115,60.90485971290885
177,The Wolverine,414828246,132556852,282271394,2013.csv,2013,31.95463502743253,68.04536497256747
178,Kingsman: The Secret Service,414351546,128261724,286089822,2015.csv,2015,30.954807635736444,69.04519236426356
179,Pacific Rim,411002906,101802906,309200000,2013.csv,2013,24.769388370212642,75.23061162978736
180,Kingsman: The Golden Circle,410902662,100234838,310667824,2017.csv,2017,24.393815681826855,75.60618431817315
181,The Mummy,409231607,80227895,329003712,2017.csv,2017,19.6045206742792,80.3954793257208
182,Ice Age: Collision Course,408579038,64063008,344516030,2016.csv,2016,15.679465180981703,84.3205348190183
183,"My People, My Country",405979670,2356683,403622987,2019.csv,2019,0.5804928606400415,99.41950713935996
184,Alita: Battle Angel,404980543,85838210,319142333,2019.csv,2019,21.195638033405473,78.80436196659453
185,Prometheus,403354469,126477084,276877385,2012.csv,2012,31.356311562275017,68.64368843772498
186,TRON: Legacy,400062763,172062763,228000000,2010.csv,2010,43.00894232438224,56.99105767561776
187,Snow White and the Huntsman,396592829,155332381,241260448,2012.csv,2012,39.16671448439125,60.83328551560876
188,Mamma Mia! Here We Go Again,395044706,120634935,274409771,2018.csv,2018,30.537033699674488,69.46296630032552
189,Solo: A Star Wars Story,392924807,213767512,179157295,2018.csv,2018,54.40417815106289,45.59582184893712
190,The Wolf of Wall Street,392000694,116900694,275100000,2013.csv,2013,29.821552815924353,70.17844718407565
191,Independence Day: Resurgence,389681935,103144286,286537649,2016.csv,2016,26.468839516514926,73.53116048348508
192,Monster Hunt,387053506,32766,387020740,2015.csv,2015,0.008465496240718719,99.99153450375928
193,Godzilla: King of the Monsters,386600138,110500138,276100000,2019.csv,2019,28.58253971963145,71.41746028036854
194,Home,386041607,177397510,208644097,2015.csv,2015,45.95295086936056,54.04704913063944
195,1917,384792488,159227644,225564844,2019.csv,2019,41.38013317973089,58.61986682026911
196,Cars 3,383930656,152901115,231029541,2017.csv,2017,39.82519046356121,60.17480953643879
197,Fifty Shades Darker,381545846,114581250,266964596,2017.csv,2017,30.030794778984436,69.96920522101556
198,Taken 2,376141306,139854287,236287019,2012.csv,2012,37.181315843041176,62.818684156958824
199,G.I. Joe: Retaliation,375740705,122523060,253217645,2013.csv,2013,32.60840743884802,67.39159256115198
200,Spider-Man: Into the Spider-Verse,375540831,190241310,185299521,2018.csv,2018,50.65795628491859,49.34204371508141
201,Mad Max: Fury Road,374736354,153636354,221100000,2015.csv,2015,40.99851865453118,59.00148134546882
202,Once Upon a Time... In Hollywood,374343626,142502728,231840898,2019.csv,2019,38.06735793065166,61.93264206934834
203,The Adventures of Tintin,373993951,77591831,296402120,2011.csv,2011,20.746814431766037,79.25318556823396
204,Penguins of Madagascar,373515621,83850911,289664710,2014.csv,2014,22.44910421028951,77.5508957897105
205,Fifty Shades Freed,371985018,100407760,271577258,2018.csv,2018,26.992420431298125,73.00757956870187
206,Captain America: The First Avenger,370569774,176654505,193915269,2011.csv,2011,47.67105074252494,52.32894925747505
207,Edge of Tomorrow,370541256,100206256,270335000,2014.csv,2014,27.04321162013873,72.95678837986127
208,Gone Girl,369330363,167767189,201563174,2014.csv,2014,45.42469447604014,54.57530552395986
209,Shazam!,365971656,140371656,225600000,2019.csv,2019,38.35588185550632,61.64411814449369
210,The Nun,365550119,117450119,248100000,2018.csv,2018,32.129689718415875,67.87031028158412
211,Night at the Museum: Secret of the Tomb,363204635,113746621,249458014,2014.csv,2014,31.3175025973994,68.6824974026006
212,The Hangover Part III,362000072,112200072,249800000,2013.csv,2013,30.99448886297459,69.00551113702541
213,Monster Hunt 2,361682618,706153,360976465,2018.csv,2018,0.1952410662986298,99.80475893370136
214,Noah,359200044,101200044,258000000,2014.csv,2014,28.173728174710355,71.82627182528964
215,The Karate Kid,359126022,176591618,182534404,2010.csv,2010,49.17260437340294,50.82739562659706
216,Hotel Transylvania,358375603,148313048,210062555,2012.csv,2012,41.38480598524448,58.615194014755524
217,Your Name.,357986087,5017246,352968841,2016.csv,2016,1.4015198305737508,98.59848016942625
218,The Legend of Tarzan,356700357,126643061,230057296,2016.csv,2016,35.50404660794887,64.49595339205113
219,Tenet,353700000,56300000,297400000,2020.csv,2020,15.917444161718972,84.08255583828102
220,The Great Gatsby,353641895,144840419,208801476,2013.csv,2013,40.9568043401645,59.04319565983549
221,Dumbo,353284621,114766307,238518314,2019.csv,2019,32.485508900768146,67.51449109923186
222,Murder on the Orient Express,352789811,102826543,249963268,2017.csv,2017,29.146687289106545,70.85331271089346
223,X-Men: First Class,352616690,146408305,206208385,2011.csv,2011,41.52052615546927,58.47947384453073
224,The Angry Birds Movie,352333929,107509366,244824563,2016.csv,2016,30.513486539640073,69.48651346035993
225,Now You See Me,351723989,117723989,234000000,2013.csv,2013,33.47056006464205,66.52943993535794
226,Peter Rabbit,351266433,115253424,236013009,2018.csv,2018,32.810827671655154,67.18917232834485
227,Mary Poppins Returns,349537494,171958438,177579056,2018.csv,2018,49.19599211865952,50.804007881340475
228,The Lorax,348840316,214030500,134809816,2012.csv,2012,61.354863581765585,38.64513641823441
229,The Maze Runner,348319861,102427862,245891999,2014.csv,2014,29.40626517992323,70.59373482007678
230,The Smurfs 2,347545360,71017784,276527576,2013.csv,2013,20.43410506185437,79.56589493814563
231,Trolls,346864462,153707064,193157398,2016.csv,2016,44.313292608223435,55.68670739177656
232,xXx: Return of Xander Cage,346118277,44898413,301219864,2017.csv,2017,12.971985585147241,87.02801441485276
233,Titanic 2012 3D Release,343550770,57884114,285666656,2012.csv,2012,16.84878016719334,83.15121983280666
234,Star Trek Beyond,343471816,158848340,184623476,2016.csv,2016,46.2478528369268,53.752147163073204
235,Alvin and the Chipmunks: Chipwrecked,342695435,133110742,209584693,2011.csv,2011,38.84228630007867,61.15771369992133
236,A Quiet Place,340939361,188024361,152915000,2018.csv,2018,55.14891576276521,44.85108423723479
237,300: Rise of an Empire,337580051,106580051,231000000,2014.csv,2014,31.571785916935003,68.428214083065
238,Journey 2: The Mysterious Island,335260290,103860290,231400000,2012.csv,2012,30.979001420060815,69.02099857993919
239,The Great Wall,334933831,45540830,289393001,2016.csv,2016,13.596963276008985,86.40303672399101
240,Now You See Me 2,334897606,65075540,269822066,2016.csv,2016,19.431473630778957,80.56852636922105
241,The Good Dinosaur,332207671,123087120,209120551,2015.csv,2015,37.05125761530052,62.94874238469947
242,22 Jump Street,331333876,191719337,139614539,2014.csv,2014,57.86288420445123,42.13711579554878
243,Black Swan,329398046,106954678,222443368,2010.csv,2010,32.46973662982809,67.53026337017191
244,John Wick: Chapter 3 - Parabellum,326709727,171015687,155694040,2019.csv,2019,52.34484096030603,47.65515903969397
245,Taken 3,326479141,89256424,237222717,2015.csv,2015,27.339089329446626,72.66091067055338
246,The SpongeBob Movie: Sponge Out of Water,325186032,162994032,162192000,2015.csv,2015,50.123318949935715,49.87668105006429
247,Megamind,321885765,148415853,173469912,2010.csv,2010,46.10823749848024,53.89176250151976
248,Green Book,321752656,85080171,236672485,2018.csv,2018,26.442725308847177,73.55727469115281
249,Robin Hood,321669741,105269730,216400011,2010.csv,2010,32.7260281532045,67.2739718467955
250,The Conjuring 2,320392818,102470008,217922810,2016.csv,2016,31.982617038562957,68.01738296143705
251,The Last Airbender,319713881,131772187,187941694,2010.csv,2010,41.21566026093187,58.78433973906814
252,The Conjuring,319494638,137400141,182094497,2013.csv,2013,43.005460705102664,56.994539294897336
253,Sonic the Hedgehog,319104189,146066470,173037719,2020.csv,2020,45.7739117928032,54.226088207196796
254,The Expendables 2,314975955,85028192,229947763,2012.csv,2012,26.995137454222494,73.0048625457775
255,Maze Runner: The Scorch Trials,312296056,81697192,230598864,2015.csv,2015,26.16017411375826,73.83982588624174
256,Resident Evil: The Final Chapter,312242626,26830068,285412558,2016.csv,2016,8.5926986791355,91.40730132086449
257,The Lego Batman Movie,311950384,175750384,136200000,2017.csv,2017,56.33921066114155,43.66078933885845
258,Knives Out,311398301,165363234,146035067,2019.csv,2019,53.10344772883009,46.8965522711699
259,Little Fockers,310650585,148438600,162211985,2010.csv,2010,47.78313873125332,52.21686126874668
260,The Ex-File 3: The Return of The Exes,307592427,838959,306753468,2017.csv,2017,0.2727502130603495,99.72724978693965
261,The Fault in Our Stars,307166834,124872350,182294484,2014.csv,2014,40.652940414784496,59.3470595852155
262,Rise of the Guardians,306941670,103412758,203528912,2012.csv,2012,33.691338813657985,66.30866118634202
263,Annabelle: Creation,306515884,102092201,204423683,2017.csv,2017,33.30731173461797,66.69268826538203
264,Wonder,305937718,132422809,173514909,2017.csv,2017,43.284237676114195,56.71576232388581
265,Skyscraper,304868961,68420120,236448841,2018.csv,2018,22.442468323300382,77.55753167669963
266,A Good Day to Die Hard,304654182,67349198,237304984,2013.csv,2013,22.106769569964413,77.89323043003559
267,Dangal,303723636,12391761,291331875,2016.csv,2016,4.079946217949267,95.92005378205073
268,Passengers,303144152,100014699,203129453,2016.csv,2016,32.992455351736425,67.00754464826358
269,Battleship,303025485,65422625,237602860,2012.csv,2012,21.589809517176416,78.41019048282358
270,Wrath of the Titans,301970083,83670083,218300000,2012.csv,2012,27.708070338875256,72.29192966112474
271,Resident Evil: Afterlife,300228084,60128566,240099518,2010.csv,2010,20.02762872776419,79.9723712722358
272,Alice Through the Looking Glass,299457024,77041381,222415643,2016.csv,2016,25.7270241889534,74.27297581104659
273,Real Steel,299268508,85468508,213800000,2011.csv,2011,28.559138604720815,71.44086139527919
274,Ocean's Eight,297718711,140218711,157500000,2018.csv,2018,47.09771533304804,52.90228466695195
275,The Divergent Series: Insurgent,297002527,130179072,166823455,2015.csv,2015,43.83096444159211,56.169035558407884
276,Miss Peregrine's Home for Peculiar Children,296482446,87242834,209239612,2016.csv,2016,29.425969455203425,70.57403054479657
277,Ferdinand,296069199,84410380,211658819,2017.csv,2017,28.510355107894895,71.4896448921051
278,Shutter Island,294804195,128012934,166791261,2010.csv,2010,43.423036771915676,56.576963228084324
279,Salt,293503354,118311368,175191986,2010.csv,2010,40.31005655901295,59.68994344098705
280,Pacific Rim: Uprising,290930148,59874525,231055623,2018.csv,2018,20.5803782837934,79.4196217162066
281,Sex and the City 2,290745055,95347692,195397363,2010.csv,2010,32.794260937645184,67.20573906235482
282,Divergent,288885818,150947895,137937923,2014.csv,2014,52.25174985917792,47.74825014082207
283,Bridesmaids,288383523,169106725,119276798,2011.csv,2011,58.63952393701772,41.36047606298228
284,Maze Runner: The Death Cure,288175335,58032443,230142892,2018.csv,2018,20.137893827728178,79.86210617227182
285,Pitch Perfect 2,287144079,184296230,102847849,2015.csv,2015,64.18249355578737,35.817506444212626
286,Oblivion,286168572,89107235,197061337,2013.csv,2013,31.13802273158074,68.86197726841927
287,Elysium,286140700,93050117,193090583,2013.csv,2013,32.51900795657521,67.48099204342479
288,John Carter,284139100,73078100,211061000,2012.csv,2012,25.719128412809077,74.28087158719092
289,Turbo,282570682,83028128,199542554,2013.csv,2013,29.383136074959115,70.61686392504089
290,Paddington,282370135,76271832,206098303,2014.csv,2014,27.01129565277858,72.98870434722143
291,The Tourist,278780441,67631157,211149284,2010.csv,2010,24.25964919109946,75.74035080890054
292,Split,278454358,138291365,140162993,2017.csv,2017,49.66392553281569,50.33607446718431
293,The Bourne Legacy,276144750,113203870,162940880,2012.csv,2012,40.99439514964525,59.00560485035476
294,Mr. Peabody & Sherman,275698039,111506430,164191609,2014.csv,2014,40.445129898076644,59.55487010192336
295,Lincoln,275293450,182207973,93085477,2012.csv,2012,66.18681737614898,33.81318262385102
296,Tomb Raider,274650803,58250803,216400000,2018.csv,2018,21.209041577060308,78.7909584229397
297,The Expendables,274470394,103068524,171401870,2010.csv,2010,37.55178199656754,62.44821800343245
298,Cloudy With a Chance of Meatballs 2,274325949,119793567,154532382,2013.csv,2013,43.66833230202368,56.331667697976314
299,Grown Ups,271430189,162001186,109429003,2010.csv,2010,59.68429178671795,40.31570821328205
300,Neighbors,270665134,150157400,120507734,2014.csv,2014,55.47718606416444,44.522813935835565
301,We're the Millers,269994119,150394119,119600000,2012.csv,2012,55.702738843730145,44.297261156269855
302,Epic,268426634,107518682,160907952,2013.csv,2013,40.05514668861064,59.94485331138936
303,Exodus: Gods and Kings,268175631,65014513,203161118,2014.csv,2014,24.243259075243863,75.75674092475614
304,Knight and Day 2010 Re-release,261930436,76423035,185507401,2010.csv,2010,29.176844114442662,70.82315588555734
305,Terminator: Dark Fate,261119292,62253077,198866215,2019.csv,2019,23.840856998034447,76.15914300196556
306,The Lone Ranger,260502115,89302115,171200000,2013.csv,2013,34.280763900899615,65.71923609910039
307,Super 8,260095986,127004179,133091807,2011.csv,2011,48.82973434276683,51.17026565723317
308,Mojin: The Lost Legend,259368448,1243810,258124638,2015.csv,2015,0.4795533186827721,99.52044668131722
309,Blade Runner 2049,259239658,92054159,167185499,2017.csv,2017,35.509288860425826,64.49071113957417
310,Kung Fu Yoga,257743016,362657,257380359,2017.csv,2017,0.14070487946800467,99.859295120532
311,Parasite,257526391,53369749,204156642,2019.csv,2019,20.723992128635857,79.27600787136414
312,Annabelle,257047661,84273813,172773848,2014.csv,2014,32.78528684997449,67.2147131500255
313,Lost in Hong Kong,256283912,1302281,254981631,2015.csv,2015,0.5081399725161054,99.4918600274839
314,Halloween,255485178,159342015,96143163,2018.csv,2018,62.36839892136522,37.63160107863479
315,Get Out,255407969,176040665,79367304,2017.csv,2017,68.92528282858707,31.074717171412924
316,Us,255184580,175084580,80100000,2019.csv,2019,68.61095603817441,31.389043961825593
317,Baahubali 2: The Conclusion,254158390,20186659,233971731,2017.csv,2017,7.942550706274147,92.05744929372585
318,Men in Black: International,253890701,80001807,173888894,2019.csv,2019,31.510333653377877,68.48966634662213
319,X-Men: Dark Phoenix,252442974,65845974,186597000,2019.csv,2019,26.083504308580995,73.916495691419
320,True Grit,252276927,171243005,81033922,2010.csv,2010,67.87898007018296,32.121019929817045
321,American Hustle,251171807,150117807,101054000,2013.csv,2013,59.76698133162692,40.23301866837308
322,Journey to the West: The Demons Strike Back,247585244,880346,246704898,2017.csv,2017,0.3555728870497629,99.64442711295024
323,Glass,246999039,111048468,135950571,2019.csv,2019,44.95906884884682,55.04093115115318
324,Grown Ups 2,246984278,133668525,113315753,2013.csv,2013,54.120256593822546,45.87974340617746
325,The Peanuts Movie,246233113,130178411,116054702,2015.csv,2015,52.86795484732389,47.13204515267611
326,Rango,245724603,123477607,122246996,2011.csv,2011,50.25040451484624,49.749595485153755
327,Teenage Mutant Ninja Turtles: Out of the Shadows,245623848,82051601,163572247,2016.csv,2016,33.40538863311025,66.59461136688975
328,Dark Shadows,245527149,79727149,165800000,2012.csv,2012,32.47182616045446,67.52817383954553
329,Dolittle,245229574,77047065,168182509,2020.csv,2020,31.418341492531404,68.5816585074686
330,The Bravest,245179562,290217,244889345,2019.csv,2019,0.11836916488169598,99.8816308351183
331,Pixels,244874809,78747585,166127224,2015.csv,2015,32.15830379677805,67.84169620322194
332,Hercules,244819862,72688614,172131248,2014.csv,2014,29.690652304999666,70.30934769500034
333,After Earth,243611982,60522097,183089885,2013.csv,2013,24.84364541642291,75.15635458357708
334,Daddy's Home,242786137,150357137,92429000,2015.csv,2015,61.929869167118056,38.070130832881944
335,RoboCop,242688965,58607007,184081958,2014.csv,2014,24.149020125410317,75.85097987458968
336,Alien: Covenant,240891763,74262031,166629732,2017.csv,2017,30.82796608533269,69.17203391466731
337,Sully,240797623,125070033,115727590,2016.csv,2016,51.93989518742052,48.06010481257948
338,Assassin's Creed,240697856,54647948,186049908,2016.csv,2016,22.70396126835463,77.29603873164537
339,Legend of Deification,240581901,214670,240367231,2020.csv,2020,0.08922948863056827,99.91077051136944
340,Resident Evil: Retribution,240159255,42345531,197813724,2012.csv,2012,17.632271136084263,82.36772886391573
341,Planes,239258712,90288712,148970000,2013.csv,2013,37.73685448912724,62.26314551087276
342,Crazy Rich Asians,238532921,174532921,64000000,2018.csv,2018,73.16932198218458,26.830678017815412
343,Gulliver's Travels,237382724,42779261,194603463,2010.csv,2010,18.021219185268087,81.9787808147319
344,Silver Linings Playbook,236412453,132092958,104319495,2012.csv,2012,55.87394247797937,44.12605752202063
345,Hidden Figures,235956898,169607287,66349611,2016.csv,2016,71.88062245164792,28.11937754835207
346,Spy,235666219,110825712,124840507,2015.csv,2015,47.02655835455145,52.97344164544856
347,American Reunion,234989584,57011521,177978063,2012.csv,2012,24.261297045404362,75.73870295459564
348,Alvin and the Chipmunks: The Road Chip,234798636,85886987,148911649,2015.csv,2015,36.578997418025885,63.421002581974115
349,The Imitation Game,233555708,91125683,142430025,2014.csv,2014,39.016679909188944,60.983320090811056
350,The Girl with the Dragon Tattoo,232617430,102515793,130101637,2011.csv,2011,44.070555246010585,55.92944475398941
351,Argo,232325503,136025503,96300000,2012.csv,2012,58.549535562611055,41.45046443738895
352,Annabelle Comes Home,231252591,74152591,157100000,2019.csv,2019,32.065626023623665,67.93437397637634
353,Ghostbusters,229147509,128350574,100796935,2016.csv,2016,56.01220565744837,43.98779434255163
354,Goodbye Mr. Loser,228122928,1293626,226829302,2015.csv,2015,0.5670740820931424,99.43292591790686
355,Paddington 2,227978523,40891591,187086932,2017.csv,2017,17.936597913655223,82.06340208634477
356,The Green Hornet,227817248,98780042,129037206,2011.csv,2011,43.35933423267408,56.64066576732593
357,Youth,227091290,1891956,225199334,2017.csv,2017,0.833125744276674,99.16687425572333
358,Baby Driver,226945087,107825862,119119225,2017.csv,2017,47.51187321362899,52.48812678637101
359,Immortals,226904017,83504017,143400000,2011.csv,2011,36.80147143450528,63.198528565494726
360,Percy Jackson & the Olympians: The Lightning Thief,226497209,88768303,137728906,2010.csv,2010,39.191786685548074,60.80821331445192
361,Hansel & Gretel: Witch Hunters,226349749,55703475,170646274,2013.csv,2013,24.60947062945495,75.39052937054504
362,Valerian and the City of a Thousand Planets,225874228,41189488,184684740,2017.csv,2017,18.235585513545175,81.76441448645483
363,Better Days,225820914,1921657,223899257,2019.csv,2019,0.850965026206563,99.14903497379343
364,Ford v Ferrari,225508210,117624357,107883853,2019.csv,2019,52.1596783549477,47.840321645052306
365,The Social Network,224920315,96962694,127957621,2010.csv,2010,43.10979824121267,56.89020175878733
366,Non-Stop,222809600,92168600,130641000,2014.csv,2014,41.36652998793589,58.633470012064116
367,Geostorm,221600160,33700160,187900000,2017.csv,2017,15.207642449355632,84.79235755064437
368,Inferno,220021259,34343574,185677685,2016.csv,2016,15.609207108482185,84.39079289151782
369,Green Lantern,219851172,116601172,103250000,2011.csv,2011,53.03641137742036,46.96358862257964
370,Captain Phillips,218791811,107100855,111690956,2013.csv,2013,48.951034552202685,51.048965447797315
371,Jack Reacher,218340595,80070736,138269859,2012.csv,2012,36.67239983476275,63.32760016523725
372,The Emoji Movie,217776646,86089513,131687133,2017.csv,2017,39.53110426725922,60.468895732740776
373,Dracula Untold,217124280,56280355,160843925,2014.csv,2014,25.92080213230874,74.07919786769126
374,Central Intelligence,216972543,127440871,89531672,2016.csv,2016,58.735943837833894,41.2640561621661
375,The Help,216639112,169708112,46931000,2011.csv,2011,78.33678343363962,21.663216566360372
376,Little Women,216601214,108101214,108500000,2019.csv,2019,49.90794465260938,50.09205534739062
377,Valentine's Day,216485654,110485654,106000000,2010.csv,2010,51.03601645585254,48.96398354414745
378,Bad Teacher,216197492,100292856,115904636,2011.csv,2011,46.389463204318766,53.61053679568124
379,Ted 2,215863606,81476385,134387221,2015.csv,2015,37.744382441197615,62.25561755880239
380,The Sorcerer's Apprentice,215283742,63150991,152132751,2010.csv,2010,29.333841196424395,70.66615880357561
381,Just Go with It,214945591,103028109,111917482,2011.csv,2011,47.93218066054679,52.067819339453216
382,The Expendables 3,214657577,39322544,175335033,2014.csv,2014,18.318730952599918,81.68126904740008
383,Creed II,214215889,115715889,98500000,2018.csv,2018,54.018350151421316,45.98164984857869
384,Smallfoot,214040103,83240103,130800000,2018.csv,2018,38.88995652370808,61.11004347629192
385,Into the Woods,212902372,128002372,84900000,2014.csv,2014,60.12256735213829,39.87743264786172
386,Bridget Jones's Baby,211952420,24252420,187700000,2016.csv,2016,11.442388815376583,88.55761118462343
387,Battle Los Angeles,211819354,83552429,128266925,2011.csv,2011,39.445134461131445,60.55486553886856
388,Fury,211817906,85817906,126000000,2014.csv,2014,40.51494400100433,59.48505599899566
389,Due Date,211780824,100539043,111241781,2010.csv,2010,47.473156965335065,52.52684303466493
390,Horrible Bosses,209838559,117538559,92300000,2011.csv,2011,56.01380392628411,43.98619607371589
391,Tomorrowland,209035668,93436322,115599346,2015.csv,2015,44.698745861878464,55.301254138121536
392,Me Before You,208314186,56245075,152069111,2016.csv,2016,27.000117505199572,72.99988249480043
393,Safe House,208076205,126373434,81702771,2012.csv,2012,60.734207450582836,39.26579254941717
394,Paranormal Activity 3,207039844,104028807,103011037,2011.csv,2011,50.245790853667756,49.754209146332244
395,London Has Fallen,205754447,62524260,143230187,2016.csv,2016,30.387804935268303,69.6121950647317
396,Journey to the West,205637183,18058,205619125,2013.csv,2013,0.008781485788005567,99.991218514212
397,White House Down,205366737,73103784,132262953,2013.csv,2013,35.596701329485505,64.4032986705145
398,A Dog's Purpose,205035819,64508620,140527199,2017.csv,2017,31.46212223533489,68.53787776466511
399,Eat Pray Love,204594016,80574010,124020006,2010.csv,2010,39.382388388133506,60.617611611866494
400,Yogi Bear,203509374,100246011,103263363,2010.csv,2010,49.258670020772605,50.74132997922739
401,Everest,203427584,43482270,159945314,2015.csv,2015,21.37481512831613,78.62518487168387
402,Arrival,203388186,100546139,102842047,2016.csv,2016,49.435584719753585,50.56441528024641
403,Need for Speed,203277636,43577636,159700000,2014.csv,2014,21.43749644943726,78.56250355056274
404,The Addams Family,203044905,100044905,103000000,2019.csv,2019,49.272305059809305,50.727694940190695
405,Birds of Prey: And the Fantabulous Emancipation of One Harley Quinn,201858461,84158461,117700000,2020.csv,2020,41.69181741656101,58.30818258343899
406,Straight Outta Compton,201634991,161197785,40437206,2015.csv,2015,79.94534291917617,20.054657080823834
407,21 Jump Street,201585328,138447667,63137661,2012.csv,2012,68.67943633278708,31.320563667212927
408,Percy Jackson: Sea of Monsters,199850315,68559554,131290761,2013.csv,2013,34.30545205795647,65.69454794204353
409,RED,199006387,90380162,108626225,2010.csv,2010,45.415709195303364,54.584290804696636
410,Total Recall,198467168,58877969,139589199,2012.csv,2012,29.6663521696445,70.33364783035549
411,The Island,198326350,670883,197655467,2018.csv,2018,0.3382722467286874,99.66172775327131
412,The Impossible,198087212,19019882,179067330,2012.csv,2012,9.601771769093302,90.3982282309067
413,Lost in Thailand,197757387,57387,197700000,2012.csv,2012,0.029018890707733717,99.97098110929227
414,Christopher Robin,197744377,99215042,98529335,2018.csv,2018,50.173382174098435,49.82661782590157
415,Jack the Giant Slayer,197687603,65187603,132500000,2013.csv,2013,32.97505863329225,67.02494136670776
416,Smurfs: The Lost Village,197183546,45020282,152163264,2017.csv,2017,22.831662637814617,77.16833736218538
417,The Other Woman,196710396,83911193,112799203,2014.csv,2014,42.65722336301941,57.34277663698059
418,The Vow,196114570,125014030,71100540,2012.csv,2012,63.745406575350316,36.254593424649684
419,The Shape of Water,195333312,63859435,131473877,2017.csv,2017,32.692547085875454,67.30745291412455
420,The BFG,195243411,55483770,139759641,2016.csv,2016,28.417742609506035,71.58225739049396
421,Rocketman,195179299,96368160,98811139,2019.csv,2019,49.37417056713581,50.62582943286419
422,The Intern,194564672,75764672,118800000,2015.csv,2015,38.940610965591944,61.05938903440805
423,Gnomeo & Juliet,193967670,99967670,94000000,2011.csv,2011,51.538315637858624,48.46168436214138
424,Downton Abbey,193820755,96854135,96966620,2019.csv,2019,49.97098220982578,50.02901779017422
425,The Monkey King 2,193678298,709982,192968316,2016.csv,2016,0.3665779838689,99.6334220161311
426,Weathering with You,193245681,7798743,185446938,2019.csv,2019,4.0356622511009705,95.96433774889903
427,The Equalizer,192330738,101530738,90800000,2014.csv,2014,52.789657574131496,47.210342425868504
428,The LEGO Movie 2: The Second Part,192306508,105806508,86500000,2019.csv,2019,55.01972299346208,44.98027700653792
429,The Equalizer 2,190400157,102084362,88315795,2018.csv,2018,53.615692134119406,46.384307865880594
430,The White Storm 2: Drug Lords,189396380,609461,188786919,2019.csv,2019,0.3217912612690908,99.67820873873092
431,Breakup Buddies,189017596,777896,188239700,2014.csv,2014,0.41154686995384276,99.58845313004616
432,The Secret Life of Walter Mitty,188133322,58236838,129896484,2013.csv,2013,30.955089391341318,69.04491060865868
433,12 Years a Slave,187733202,56671993,131061209,2013.csv,2013,30.187517389704993,69.812482610295
434,Mr. Popper's Penguins,187361754,68224452,119137302,2011.csv,2011,36.413222305764705,63.586777694235295
435,Hugo,185770160,73864507,111905653,2011.csv,2011,39.761233451055865,60.238766548944135
436,The Lion King 2011 3D Release,185542001,94242001,91300000,2011.csv,2011,50.792812674258045,49.20718732574195
437,Pitch Perfect 3,185400345,104897530,80502815,2017.csv,2017,56.57892923554161,43.42107076445839
438,Hop,183953723,108085305,75868418,2011.csv,2011,58.75679123928359,41.24320876071641
439,Bad Moms,183936074,113257297,70678777,2016.csv,2016,61.574271178583494,38.42572882141651
440,Jupiter Ascending,183887723,47387723,136500000,2015.csv,2015,25.769922117095334,74.23007788290467
441,Storks,183388953,72679278,110709675,2016.csv,2016,39.63121922616571,60.36878077383429
442,Mirror Mirror,183018522,64935167,118083355,2012.csv,2012,35.48010676209045,64.51989323790956
443,Daddy's Home 2,180613180,104029443,76583737,2017.csv,2017,57.597924470406866,42.402075529593134
444,Hacksaw Ridge,180450918,67209615,113241303,2016.csv,2016,37.24537161955585,62.754628380444146
445,The Post,179769457,81903458,97865999,2017.csv,2017,45.56027445752367,54.439725542476324
446,The Dictator,179379533,59650222,119729311,2012.csv,2012,33.25363880839181,66.74636119160819
447,Allegiant,179246868,66184051,113062817,2016.csv,2016,36.923407219589464,63.076592780410536
448,Abominable,179057149,60716390,118340759,2019.csv,2019,33.90894490339506,66.09105509660493
449,Baywatch,177856751,58060186,119796565,2017.csv,2017,32.644353207599075,67.35564679240092
450,War Horse,177584879,79884879,97700000,2011.csv,2011,44.98405463902137,55.01594536097863
451,Paranormal Activity 2,177512032,84752907,92759125,2010.csv,2010,47.74488018930458,52.255119810695426
452,Lee Daniels' The Butler,177313795,116632095,60681700,2013.csv,2013,65.77722562421046,34.22277437578954
453,The Descendants,177243185,82584160,94659025,2011.csv,2011,46.59370119082435,53.40629880917566
454,The A-Team,177238796,77222099,100016697,2010.csv,2010,43.56952357090036,56.43047642909964
455,The Hitman's Bodyguard,176586701,75468583,101118118,2017.csv,2017,42.73741033306919,57.26258966693081
456,Looper,176506819,66486205,110020614,2012.csv,2012,37.6677826820957,62.3322173179043
457,Ip Man 4: The Finale,176345966,3956031,172389935,2019.csv,2019,2.243335126815433,97.75666487318456
458,Cowboys & Aliens,174822325,100240551,74581774,2011.csv,2011,57.33852984737504,42.66147015262496
459,The Mule,174804407,103804407,71000000,2018.csv,2018,59.383175047754946,40.616824952245054
460,Identity Thief,173965010,134506920,39458090,2013.csv,2013,77.31837568945618,22.681624310543828
461,The Nutcracker and the Four Realms,173961069,54858851,119102218,2018.csv,2018,31.53513100106323,68.46486899893677
462,In Time,173930596,37520095,136410501,2011.csv,2011,21.5718774401256,78.4281225598744
463,Operation Mekong,173839072,800012,173039060,2016.csv,2016,0.46020264075040623,99.53979735924959
464,Creed,173567581,109767581,63800000,2015.csv,2015,63.241983536084426,36.758016463915574
465,Gemini Man,173469516,48546770,124922746,2019.csv,2019,27.98576436911255,72.01423563088744
466,The Girl on the Train,173185859,75395035,97790824,2016.csv,2016,43.5341750390833,56.4658249609167
467,The Grand Budapest Hotel,172936941,59301324,113635617,2014.csv,2014,34.2907210322403,65.7092789677597
468,Jackass 3D,171685792,117229692,54456100,2010.csv,2010,68.28153374508707,31.71846625491293
469,Spies in Disguise,171616764,66757013,104859751,2019.csv,2019,38.89888810629246,61.10111189370754
470,John Wick: Chapter 2,171539887,92029184,79510703,2017.csv,2017,53.6488542749244,46.3511457250756
471,Anchorman 2: The Legend Continues,171464676,125168368,46296308,2013.csv,2013,72.99950690718362,27.00049309281639
472,The Other Guys,170458922,119219978,51238944,2010.csv,2010,69.9405913173615,30.059408682638505
473,Olympus Has Fallen,170270201,98925640,71344561,2013.csv,2013,58.09920903305916,41.90079096694083
474,Zookeeper,169852759,80360843,89491916,2011.csv,2011,47.312062207950355,52.687937792049645
475,Dumb and Dumber To,169837010,86208010,83629000,2014.csv,2014,50.75926030492411,49.24073969507589
476,Ghost in the Shell,169801921,40563557,129238364,2017.csv,2017,23.888750351652384,76.11124964834762
477,Insidious: The Last Key,167885588,67745330,100140258,2018.csv,2018,40.35208191902691,59.64791808097309
478,Fantastic Four,167882881,56117548,111765333,2015.csv,2015,33.426605301108694,66.5733946988913
479,Unstoppable,167805466,81562942,86242524,2010.csv,2010,48.60565269071748,51.39434730928253
480,Magic Mike,167739368,113721571,54017797,2012.csv,2012,67.79658964733908,32.203410352660924
481,Bridge of Spies,165478348,72313754,93164594,2015.csv,2015,43.69982833041094,56.30017166958906
482,The Muppets,165184237,88631237,76553000,2011.csv,2011,53.655989584526765,46.34401041547324
483,The Huntsman: Winter's War,164989338,48390190,116599148,2016.csv,2016,29.32928308373478,70.67071691626522
484,The Magnificent Seven,162360636,93432655,68927981,2016.csv,2016,57.54637164638847,42.45362835361152
485,Jack Reacher: Never Go Back,162146076,58697076,103449000,2016.csv,2016,36.20012117962077,63.79987882037922
486,Insidious: Chapter 2,161919318,83586447,78332871,2013.csv,2013,51.62228203060983,48.37771796939016
487,Limitless,161849455,79249455,82600000,2011.csv,2011,48.9649192825518,51.0350807174482
488,Flight,161772375,93772375,68000000,2012.csv,2012,57.96562917494411,42.03437082505588
489,Into the Storm,161502194,47602194,113900000,2014.csv,2014,29.474642307336087,70.52535769266392
490,Unbroken,161459297,115637895,45821402,2014.csv,2014,71.62046233856698,28.379537661433023
491,The Predator,160542134,51024708,109517426,2018.csv,2018,31.782751810188348,68.21724818981166
492,"Three Billboards Outside Ebbing, Missouri",160192031,54513740,105678291,2017.csv,2017,34.03024461310438,65.96975538689563
493,Underworld: Awakening,160112671,62321039,97791632,2012.csv,2012,38.92323987275186,61.07676012724814
494,Johnny English Reborn,160078586,8305970,151772616,2011.csv,2011,5.188682763602123,94.81131723639787
495,Step Up 3D,159291809,42400223,116891586,2010.csv,2010,26.617955603731012,73.38204439626898
496,Happy Feet Two,159196259,64006466,95189793,2011.csv,2011,40.20601137367179,59.79398862632821
497,Johnny English Strikes Again,158970776,4412170,154558606,2018.csv,2018,2.7754598115568108,97.22454018844319
498,Focus,158762963,53862963,104900000,2015.csv,2015,33.92665517334795,66.07334482665205
499,Goosebumps,158260952,80080379,78180573,2015.csv,2015,50.60021312142745,49.39978687857255
500,Final Destination 5,157887643,42587643,115300000,2011.csv,2011,26.973385751283907,73.02661424871609
501,Don't Breathe,157830487,89217875,68612612,2016.csv,2016,56.52765615555631,43.47234384444369
502,Hustlers,157563598,104963598,52600000,2019.csv,2019,66.61665469203109,33.383345307968916
503,The Book of Eli,157107755,94835059,62272696,2010.csv,2010,60.36306673722122,39.63693326277878
504,Ip Man 3,156954938,2679437,154275501,2015.csv,2015,1.7071377518558861,98.2928622481441
505,The Climbers,156892866,487157,156405709,2019.csv,2019,0.31050296448788184,99.68949703551212
506,This Means War,156491279,54760791,101730488,2012.csv,2012,34.99287075288074,65.00712924711925
507,The Hateful Eight,155760117,54117416,101642701,2015.csv,2015,34.74407765114866,65.25592234885134
508,Escape Room,155712077,57005601,98706476,2019.csv,2019,36.60962084527329,63.39037915472671
509,The Monuments Men,155641650,78031620,77610030,2014.csv,2014,50.13543611237738,49.86456388762262
510,The Accountant,155160045,86260045,68900000,2016.csv,2016,55.594238194504264,44.405761805495736
511,Lone Survivor,154802912,125095601,29707311,2013.csv,2013,80.80959161801815,19.190408381981857
512,Ride Along,154468902,134938200,19530702,2014.csv,2014,87.35622397315933,12.643776026840664
513,The Town,154026136,92186262,61839874,2010.csv,2010,59.8510515124524,40.14894848754759
514,Midnight in Paris,153959590,56817045,97142545,2011.csv,2011,36.903868735945586,63.09613126405442
515,Yesterday,153178301,73286650,79891651,2019.csv,2019,47.84401545229308,52.15598454770692
516,Tower Heist,152930623,78046570,74884053,2011.csv,2011,51.03397113604906,48.966028863950946
517,Duckweed,152894264,471575,152422689,2017.csv,2017,0.30843210704098095,99.69156789295901
518,Date Night,152263880,98711404,53552476,2010.csv,2010,64.82916631311379,35.17083368688622
519,Jackass Presents: Bad Grandpa,151826547,102003019,49823528,2013.csv,2013,67.18391547164674,32.816084528353265
520,47 Ronin,151783839,38362475,113421364,2013.csv,2013,25.274413437388414,74.72558656261158
521,Red Sparrow,151572634,46874505,104698129,2018.csv,2018,30.925440670246584,69.07455932975341
522,Darkest Hour,150847207,56468410,94378797,2017.csv,2017,37.43417668979446,62.56582331020554
523,Gods of Egypt,150680864,31153464,119527400,2015.csv,2015,20.675129656808977,79.32487034319102
524,I Am Number Four,149878437,55100437,94778000,2011.csv,2011,36.76341847626821,63.23658152373179
525,Jack and Jill,149673788,74158157,75515631,2011.csv,2011,49.54652246791535,50.45347753208465
526,Friends with Benefits,149542245,55802754,93739491,2011.csv,2011,37.31571235940721,62.68428764059279
527,No Strings Attached,149228077,70662220,78565857,2011.csv,2011,47.3518264260686,52.6481735739314
528,Lights Out,148868835,67268835,81600000,2016.csv,2016,45.186647023871714,54.813352976128286
529,The Secret World of Arrietty,148800274,19202743,129597531,2010.csv,2010,12.905045457107157,87.09495454289285
530,King Arthur: Legend of the Sword,148675066,39175066,109500000,2017.csv,2017,26.34945257061463,73.65054742938537
531,RED 2,148075565,53262560,94813005,2013.csv,2013,35.969850933879606,64.0301490661204
532,The Angry Birds Movie 2,147792047,41667116,106124931,2019.csv,2019,28.19307049722371,71.80692950277628
533,Arthur Christmas,147419472,46462469,100957003,2011.csv,2011,31.517185870805452,68.48281412919455
534,Source Code,147332697,54712227,92620470,2011.csv,2011,37.135156088264644,62.864843911735356
535,Planes: Fire & Rescue,146965787,59165787,87800000,2014.csv,2014,40.258204448631304,59.7417955513687
536,The Last Witch Hunter,146936910,27367660,119569250,2015.csv,2015,18.625449521158437,81.37455047884157
537,Angel Has Fallen,146661977,69030436,77631541,2019.csv,2019,47.0677113537069,52.9322886462931
538,Mama,146428180,71628180,74800000,2013.csv,2013,48.916936616981786,51.083063383018214
539,The Foreigner,145374099,34393507,110980592,2017.csv,2017,23.658620921186245,76.34137907881376
540,"Crazy, Stupid, Love.",145051197,84351197,60700000,2011.csv,2011,58.15270659227997,41.84729340772003
541,Pete's Dragon,143695338,76233151,67462187,2016.csv,2016,53.05193060612725,46.94806939387275
542,More Than Blue,142958164,722669,142235495,2018.csv,2018,0.5055108290282743,99.49448917097172
543,Paranormal Activity 4,142802657,53885000,88917657,2012.csv,2012,37.733891744045074,62.26610825595493
544,Power Rangers,142337240,85364450,56972790,2017.csv,2017,59.97337731151735,40.02662268848265
545,New Year's Eve,142044638,54544638,87500000,2011.csv,2011,38.399645891596414,61.600354108403586
546,The Taking of Tiger Mountain,141654055,228984,141425071,2014.csv,2014,0.16165015537324365,99.83834984462676
547,Onward,141517253,61555145,79962108,2020.csv,2020,43.496565750891165,56.50343424910883
548,Trainwreck,140795793,110212700,30583093,2015.csv,2015,78.27840424180856,21.72159575819144
549,Sausage Party,140705322,97685686,43019636,2016.csv,2016,69.42572221966131,30.574277780338686
550,Girls Trip,140552359,115171585,25380774,2017.csv,2017,81.94212165446473,18.057878345535276
551,Step Up Revolution,140470746,35074677,105396069,2012.csv,2012,24.969381881121354,75.03061811887865
552,Lion,140312928,51738905,88574023,2016.csv,2016,36.87394008341127,63.12605991658873
553,Legend of the Guardians: The Owls of Ga'Hoole,140073390,55675313,84398077,2010.csv,2010,39.74724464082721,60.25275535917278
554,The Wolfman,139789765,61979680,77810085,2010.csv,2010,44.33778109577622,55.66221890422378
555,Mr. Six,139191345,1415450,137775895,2015.csv,2015,1.0169094924688027,98.9830905075312
556,The Admiral: Roaring Currents,138342258,2589811,135752447,2014.csv,2014,1.8720317547513212,98.12796824524868
557,Let's Be Cops,138224951,82390774,55834177,2014.csv,2014,59.606296405921675,40.393703594078325
558,Escape Plan,137328301,25135965,112192336,2013.csv,2013,18.303557836923943,81.69644216307606
559,The First Purge,137056262,69488745,67567517,2018.csv,2018,50.70089026650968,49.299109733490326
560,Annie,136853506,85911262,50942244,2014.csv,2014,62.77607677804031,37.223923221959694
561,The Best Exotic Marigold Hotel,136836156,46412041,90424115,2012.csv,2012,33.91796609662142,66.08203390337857
562,How Long Will I Love U,136796719,746933,136049786,2018.csv,2018,0.5460167505918033,99.4539832494082
563,Contagion,136515867,75658097,60857770,2011.csv,2011,55.42073508568788,44.57926491431212
564,The Wind Rises,136454220,5209580,131244640,2012.csv,2012,3.8178225634941887,96.18217743650581
565,The Bounty Hunter,136333522,67061228,69272294,2010.csv,2010,49.18909672120112,50.81090327879888
566,Saw: The Final Chapter,136150434,45710178,90440256,2010.csv,2010,33.57328849939619,66.4267115006038
567,Unknown,135710029,63686397,72023632,2011.csv,2011,46.92829076029451,53.07170923970549
568,Jack Ryan: Shadow Recruit,135503748,50577412,84926336,2014.csv,2014,37.32547087922616,62.67452912077383
569,American Made,134866593,51342000,83524593,2017.csv,2017,38.06873063072039,61.931269369279605
570,Wall Street: Money Never Sleeps,134748021,52474616,82273405,2010.csv,2010,38.942773044510986,61.05722695548902
571,Last Vegas,134402450,63914167,70488283,2012.csv,2012,47.55431690419334,52.44568309580666
572,Point Break,133718711,28782481,104936230,2015.csv,2015,21.524647362178058,78.47535263782194
573,The Big Short,133440870,70259870,63181000,2015.csv,2015,52.652436993254014,47.347563006745986
574,The Artist,133432856,44671682,88761174,2011.csv,2011,33.478772274798644,66.52122772520136
575,Zero Dark Thirty,132820716,95720716,37100000,2012.csv,2012,72.06761029657453,27.932389703425482
576,A Wrinkle in Time,132675864,100478608,32197256,2018.csv,2018,75.73239394921144,24.267606050788558
577,Ghost Rider: Spirit of Vengeance,132563930,51774002,80789928,2012.csv,2012,39.05587439961987,60.94412560038014
578,The Three Musketeers,132274484,20374484,111900000,2011.csv,2011,15.403185394395491,84.59681460560451
579,2 Guns,131940411,75612460,56327951,2013.csv,2013,57.30803733815867,42.69196266184134
580,The House with a Clock in Its Walls,131457147,68549695,62907452,2018.csv,2018,52.146038891289805,47.8539611087102
581,The Invisible Man,130560433,64914050,65646383,2020.csv,2020,49.71954252020595,50.28045747979405
582,A Bad Moms Christmas,130560428,72110659,58449769,2017.csv,2017,55.23163496369665,44.768365036303344
583,Cloud Atlas,130482868,27108272,103374596,2012.csv,2012,20.77534960375028,79.22465039624971
584,The Woman in Black,128955898,54333290,74622608,2012.csv,2012,42.13323379749564,57.86676620250436
585,Pan,128388320,35088320,93300000,2015.csv,2015,27.329838103653042,72.67016189634695
586,Blended,127994610,46294610,81700000,2014.csv,2014,36.169187124364065,63.830812875635935
587,The Adjustment Bureau,127869379,62495645,65373734,2010.csv,2010,48.87459803804944,51.125401961950566
588,Ad Astra,127461872,50188370,77273502,2019.csv,2019,39.3752023350167,60.6247976649833
589,Predators,127233108,52000688,75232420,2010.csv,2010,40.87040615246151,59.12959384753849
590,Midway,126696475,56846802,69849673,2019.csv,2019,44.86849535474448,55.131504645255525
591,Chronicle,126636097,64575175,62060922,2012.csv,2012,50.99270786906833,49.007292130931674
592,Walking with Dinosaurs 3D,126546518,36076121,90470397,2012.csv,2012,28.508189375862557,71.49181062413744
593,Sex Tape,126069509,38543473,87526036,2014.csv,2014,30.573191968249837,69.42680803175017
594,This Is the End,126041322,101470202,24571120,2013.csv,2013,80.50550437736602,19.49449562263398
595,The Upside,125852517,108252517,17600000,2019.csv,2019,86.0153770305603,13.984622969439698
596,Detective Chinatown,125842935,474252,125368683,2015.csv,2015,0.3768602504383738,99.62313974956163
597,Wolf Totem,125837070,210591,125626479,2015.csv,2015,0.16735211651065937,99.83264788348934
598,Mechanic: Resurrection,125729635,21218403,104511232,2016.csv,2016,16.87621458536804,83.12378541463195
599,Ender's Game,125544024,61737191,63806833,2013.csv,2013,49.17573057878087,50.82426942121913
600,Happy Death Day,125479266,55683845,69795421,2017.csv,2017,44.37692917330263,55.62307082669737
601,Captain Underpants: The First Epic Movie,125427681,73921000,51506681,2017.csv,2017,58.93515642691345,41.06484357308655
602,Ride Along 2,124605297,91221830,33383467,2015.csv,2015,73.20862932496361,26.79137067503639
603,The Theory of Everything,123726688,35893537,87833151,2014.csv,2014,29.01034334645731,70.98965665354268
604,The Curse of la Llorona,123133739,54733739,68400000,2019.csv,2019,44.45064321485438,55.54935678514562
605,The Lego Ninjago Movie,123081555,59281555,63800000,2017.csv,2017,48.164450798496986,51.835549201503014
606,The Pirates! Band of Misfits,123054041,31051126,92002915,2012.csv,2012,25.233731251458863,74.76626874854114
607,Looking Up,122994583,84267,122910316,2019.csv,2019,0.06851277344466462,99.93148722655533
608,Zombieland: Double Tap,122810399,73123082,49687317,2019.csv,2019,59.54144160056023,40.458558399439774
609,Dragon Blade,122593849,74068,122519781,2015.csv,2015,0.06041738684621934,99.93958261315377
610,Prisoners,122126687,61002302,61124385,2013.csv,2013,49.950017885935125,50.04998211406488
611,Secret Superstar,122026260,0,122026260,2017.csv,2017,0.0,100.0
612,Deepwater Horizon,121790373,61433527,60356846,2016.csv,2016,50.44202221139433,49.557977788605676
613,Last Christmas,121550750,35150750,86400000,2019.csv,2019,28.91857927655732,71.08142072344268
614,The Nut Job,120885527,64251541,56633986,2014.csv,2014,53.150730773585494,46.849269226414506
615,Instant Family,120556201,67363237,53192964,2018.csv,2018,55.87704028596588,44.122959714034124
616,We Bought a Zoo,120081841,75624550,44457291,2011.csv,2011,62.977507148645394,37.022492851354606
617,The Commuter,119942387,36343858,83598529,2017.csv,2017,30.301096142100292,69.69890385789971
618,Extreme Job,119932733,1565885,118366848,2019.csv,2019,1.3056360518358237,98.69436394816418
619,Parental Guidance,119772232,77267296,42504936,2012.csv,2012,64.51186114658029,35.48813885341971
620,Dora and the Lost City of Gold,119682635,60477943,59204692,2019.csv,2019,50.5319280445321,49.46807195546789
621,Wonder Park,119559110,45216793,74342317,2019.csv,2019,37.81961324402632,62.180386755973686
622,Allied,119520023,40098064,79421959,2016.csv,2016,33.54924387857589,66.4507561214241
623,I Belonged to You,119107580,744541,118363039,2016.csv,2016,0.6250995948368693,99.37490040516313
624,The Shallows,119100758,55124043,63976715,2016.csv,2016,46.2835366673317,53.7164633326683
625,The Purge: Election Year,118587880,79213375,39374505,2016.csv,2016,66.79719293405026,33.20280706594974
626,Jurassic Park 2013 Re-release,118192315,45385935,72806380,2013.csv,2013,38.400072796611184,61.599927203388816
627,A Cool Fish,118153135,551876,117601259,2018.csv,2018,0.4670853634141828,99.53291463658582
628,Why Him?,118102725,60323786,57778939,2016.csv,2016,51.07738707976467,48.92261292023533
629,P Storm,117991727,326711,117665016,2019.csv,2019,0.27689314183866465,99.72310685816133
630,Saving Mr. Banks,117867984,83301580,34566404,2013.csv,2013,70.67362753909492,29.326372460905077
631,Pompeii,117831631,23219748,94611883,2014.csv,2014,19.705869979852864,80.29413002014714
632,Magic Mike XXL,117813057,66013057,51800000,2015.csv,2015,56.03203811271954,43.96796188728045
633,Game Night,117679066,69179066,48500000,2018.csv,2018,58.78621266419637,41.21378733580364
634,Water for Elephants,117094902,58709717,58385185,2011.csv,2011,50.13857648559286,49.86142351440714
635,Warm Bodies,116980662,66380662,50600000,2013.csv,2013,56.74498747493838,43.25501252506162
636,Abraham Lincoln: Vampire Hunter,116471580,37519139,78952441,2012.csv,2012,32.21312787205257,67.78687212794743
637,Personal Tailor,116126458,375892,115750566,2013.csv,2013,0.3236919531292343,99.67630804687076
638,The Iron Lady,115890699,30017992,85872707,2011.csv,2011,25.901985456140874,74.09801454385912
639,A Nightmare on Elm Street,115694863,63075011,52619852,2010.csv,2010,54.518419715834746,45.481580284165254
640,Dragon Ball Super: Broly,115560610,30712119,84848491,2018.csv,2018,26.576632816320373,73.42336718367963
641,Pitch Perfect,115350426,65001093,50349333,2012.csv,2012,56.35097784554346,43.64902215445654
642,The Gentlemen,115171795,36471795,78700000,2019.csv,2019,31.667297535824634,68.33270246417537
643,The Monkey King 3,115084576,187074,114897502,2018.csv,2018,0.16255349457081025,99.8374465054292
644,Dear John,114984666,80014842,34969824,2010.csv,2010,69.58740220195969,30.41259779804031
645,So Young,114926694,11186,114915508,2013.csv,2013,0.009733160861653255,99.99026683913834
646,Finding Mr Right 2,114679097,0,114679097,2016.csv,2016,0.0,100.0
647,Office Christmas Party,114501299,54767494,59733805,2016.csv,2016,47.83132984369025,52.16867015630976
648,Hope Springs,114281051,63536011,50745040,2012.csv,2012,55.59627816163504,44.40372183836496
649,Seventh Son,114178613,17223265,96955348,2014.csv,2014,15.084493100297165,84.91550689970285
650,The Dark Tower,113231078,50701325,62529753,2017.csv,2017,44.776863291895886,55.223136708104114
651,Pet Sematary,113118226,54724696,58393530,2019.csv,2019,48.378318804257056,51.621681195742944
652,Insidious: Chapter 3,112983889,52218558,60765331,2015.csv,2015,46.21770277353438,53.78229722646562
653,Deliver Us from Evil,112781920,30577122,82204798,2014.csv,2014,27.111723226559718,72.88827677344028
654,Cats & Dogs: The Revenge of Kitty Galore,112483764,43585753,68898011,2010.csv,2010,38.74848373672844,61.251516263271554
655,Tooth Fairy,112462508,60022256,52440252,2010.csv,2010,53.370902950163625,46.629097049836375
656,How to Be Single,112343513,46843513,65500000,2016.csv,2016,41.69667811616324,58.303321883836766
657,The Purge: Anarchy,111928365,71962800,39965565,2014.csv,2014,64.2936220858761,35.70637791412391
658,Get Hard,111711453,90411453,21300000,2015.csv,2015,80.9330203591569,19.066979640843094
659,Good Boys,111037232,83140306,27896926,2019.csv,2019,74.8760613917321,25.1239386082679
660,Free Birds,110387072,55750480,54636592,2013.csv,2013,50.50453734292364,49.49546265707637
661,10 Cloverfield Lane,110216998,72082998,38134000,2016.csv,2016,65.40098107190326,34.59901892809674
662,Moneyball,110206216,75605492,34600724,2011.csv,2011,68.6036548065492,31.39634519345079
663,Buddies in India,110155128,293194,109861934,2017.csv,2017,0.2661646401064506,99.73383535989355
664,The 5th Wave,109906372,34916787,74989585,2015.csv,2015,31.76957474312772,68.23042525687228
665,Along With the Gods: The Two Worlds,109383972,1908823,107475149,2017.csv,2017,1.7450664526974757,98.25493354730253
666,Sanctum,108609310,23209310,85400000,2010.csv,2010,21.36954005140075,78.63045994859925
667,The Boxtrolls,108255770,50837305,57418465,2014.csv,2014,46.960365253510275,53.039634746489725
668,Neighbors 2: Sorority Rising,108007109,55455765,52551344,2016.csv,2016,51.34455084803723,48.65544915196276
669,Horrible Bosses 2,107645357,54445357,53200000,2014.csv,2014,50.578453653138055,49.421546346861945
670,The Call of the Wild,107604626,62342368,45262258,2020.csv,2020,57.9365128781731,42.063487121826896
671,Paul Blart: Mall Cop 2,107588225,71038190,36550035,2015.csv,2015,66.0278483077493,33.972151692250705
672,Vacation,107228221,58884188,48344033,2015.csv,2015,54.91482321617552,45.08517678382448
673,ParaNorman,107139399,56003051,51136348,2012.csv,2012,52.27120137196215,47.72879862803785
674,The Man from U.N.C.L.E.,107045109,45445109,61600000,2015.csv,2015,42.4541666821975,57.5458333178025
675,The Breakup Guru,106980263,208959,106771304,2014.csv,2014,0.19532481426036502,99.80467518573963
676,Hereafter,106956330,32746941,74209389,2010.csv,2010,30.617113545313305,69.3828864546867
677,Shaun the Sheep Movie,106209378,19375982,86833396,2015.csv,2015,18.243193176406702,81.7568068235933
678,Life as We Know It,105734416,53374681,52359735,2010.csv,2010,50.479950634049,49.52004936595101
679,First Man,105697415,44936545,60760870,2018.csv,2018,42.51432733714443,57.48567266285557
680,Gangster Squad,105200903,46000903,59200000,2013.csv,2013,43.72671877160598,56.273281228394026
681,Sisters,105011053,87044645,17966408,2015.csv,2015,82.89093625220576,17.109063747794245
682,The Campaign,104907746,86907746,18000000,2012.csv,2012,82.84206773444545,17.15793226555454
683,Let the Bullets Fly,104723314,63012,104660302,2010.csv,2010,0.060169982779574756,99.93983001722042
684,Scary Stories to Tell in the Dark,104545505,68947075,35598430,2019.csv,2019,65.94934425922952,34.050655740770495
685,Book Club,104438188,68566296,35871892,2018.csv,2018,65.65251400187066,34.34748599812934
686,Ouija,103590271,50856010,52734261,2014.csv,2014,49.09342306865864,50.90657693134136
687,Birdman or (The Unexpected Virtue of Ignorance),103215094,42340598,60874496,2014.csv,2014,41.02171141751806,58.978288582481945
688,Cold War II,103197501,560824,102636677,2016.csv,2016,0.5434472681659219,99.45655273183408
689,Night School,103105878,77339130,25766748,2018.csv,2018,75.009428657404,24.990571342596006
690,Transcendence,103039258,23022309,80016949,2014.csv,2014,22.343240282262126,77.65675971773788
691,Jigsaw,102952888,38052832,64900056,2017.csv,2017,36.96140316141496,63.03859683858505
692,Love & Other Drugs,102820008,32367005,70453003,2010.csv,2010,31.479286599549766,68.52071340045023
693,Chappie,102811889,31569268,71242621,2015.csv,2015,30.705853483540217,69.29414651645979
694,Star Wars: Episode I - The Phantom Menace 2012 3D Release,102739593,43456382,59283211,2012.csv,2012,42.29759991359903,57.702400086400964
695,Project X,102731865,54731865,48000000,2012.csv,2012,53.27642499238186,46.72357500761814
696,Railroad Tigers,102205175,218044,101987131,2016.csv,2016,0.2133394908819441,99.78666050911805
697,Heaven Is for Real,101888019,91443253,10444766,2014.csv,2014,89.74877900020806,10.251220999791938
698,The Devil Inside,101758490,53261944,48496546,2012.csv,2012,52.34152354265477,47.65847645734523
699,Joy,101134059,56451232,44682827,2015.csv,2015,55.81822044737669,44.18177955262332
700,"Alexander and the Terrible, Horrible, No Good, Very Bad Day",100654149,66954149,33700000,2014.csv,2014,66.5190155251325,33.4809844748675
701,Life,100541806,30234022,70307784,2017.csv,2017,30.071095003008004,69.928904996992
702,Instructions Not Included,100486616,44467206,56019410,2013.csv,2013,44.25186932357241,55.7481306764276
703,Tammy,100375432,84525432,15850000,2014.csv,2014,84.20928340313395,15.790716596866053
704,PK,100370104,10616104,89754000,2014.csv,2014,10.576958254422054,89.42304174557795
705,Aftershock,100293273,62962,100230311,2010.csv,2010,0.06277788940041872,99.93722211059958
706,Philomena,100129872,37709979,62419893,2013.csv,2013,37.6610678180034,62.3389321819966
707,Atomic Blonde,100014025,51687870,48326155,2017.csv,2017,51.68062179279356,48.319378207206434
708,The Book of Life,99783556,50151543,49632013,2014.csv,2014,50.26032846534353,49.73967153465647
709,Black Mass,99775678,62575678,37200000,2015.csv,2015,62.71636460340565,37.28363539659435
710,Insidious,99557032,54009150,45547882,2011.csv,2011,54.24945773795265,45.75054226204735
711,Line Walker 2: Invisible Spy,99482027,296751,99185276,2019.csv,2019,0.2982960932229497,99.70170390677706
712,The Lucky One,99357138,60457138,38900000,2012.csv,2012,60.848308653979146,39.151691346020854
713,Blue Jasmine,99104804,33405481,65699323,2013.csv,2013,33.70722674553698,66.29277325446303
714,Ode To My Father,99085291,2300121,96785170,2014.csv,2014,2.3213546398122804,97.67864536018772
715,Justin Bieber: Never Say Never,99036827,73013910,26022917,2011.csv,2011,73.72399965923788,26.276000340762128
716,Young Detective Dee: Rise of the Sea Dragon,98774891,87783,98687108,2013.csv,2013,0.08887177612780155,99.9111282238722
717,Spotlight,98690254,45055776,53634478,2015.csv,2015,45.653723821604515,54.34627617839549
718,Devil and Angel,98599942,131058,98468884,2015.csv,2015,0.1329189422849762,99.86708105771503
719,The Visit,98450062,65206105,33243957,2015.csv,2015,66.2326703257942,33.76732967420579
720,Riddick,98337295,42025135,56312160,2013.csv,2013,42.735703681904205,57.264296318095795
721,Alpha,98203196,35857181,62346015,2018.csv,2018,36.513252582940375,63.48674741705962
722,Killers,98159963,47059963,51100000,2010.csv,2010,47.94211566685289,52.05788433314711
723,Paul,97984015,37412945,60571070,2011.csv,2011,38.18270255612612,61.817297443873876
724,Along With the Gods: The Last 49 Days,97962238,1200246,96761992,2018.csv,2018,1.2252129233715547,98.77478707662844
725,A Simple Favor,97644617,53548586,44096031,2018.csv,2018,54.84028474401206,45.15971525598795
726,Safe Haven,97594140,71349120,26245020,2013.csv,2013,73.1079960333684,26.892003966631606
727,The Little Prince,97571250,1339152,96232098,2015.csv,2015,1.3724862600407395,98.62751373995926
728,Evil Dead,97542952,54239856,43303096,2013.csv,2013,55.60612518677925,44.39387481322075
729,42,97470701,95020213,2450488,2013.csv,2013,97.48592348792074,2.5140765120792556
730,Scream 4,97138686,38180928,58957758,2011.csv,2011,39.305584183010254,60.694415816989746
731,The Shack,96942115,57386418,39555697,2017.csv,2017,59.19658138261168,40.803418617388324
732,The Rite,96560591,33047633,63512958,2011.csv,2011,34.22476256384967,65.77523743615032
733,Contraband,96262212,66528000,29734212,2012.csv,2012,69.11123131057907,30.88876868942093
734,Kick-Ass,96188903,48071303,48117600,2010.csv,2010,49.97593433413,50.02406566587
735,Assassination,96119773,1904682,94215091,2015.csv,2015,1.9815714712518098,98.01842852874819
736,Think Like a Man,96070507,91547205,4523302,2012.csv,2012,95.29168509540602,4.708314904593977
737,Dolphin Tale,95932565,72286779,23645786,2011.csv,2011,75.35165874069978,24.648341259300217
738,The Favourite,95918706,34366783,61551923,2018.csv,2018,35.82907279837574,64.17092720162427
739,Some Like It Hot,95721320,100026,95621294,2016.csv,2016,0.10449709636264941,99.89550290363735
740,Poltergeist,95437994,47425125,48012869,2015.csv,2015,49.69208070320506,50.30791929679494
741,The Mortal Instruments: City of Bones,95396573,31165421,64231152,2013.csv,2013,32.669329746258285,67.33067025374172
742,Truth or Dare,95330493,41411015,53919478,2018.csv,2018,43.43942184375361,56.5605781562464
743,Rush,95224595,26947624,68276971,2013.csv,2013,28.29901665635858,71.70098334364143
744,The Hustle,95017038,35417038,59600000,2019.csv,2019,37.27440756467277,62.72559243532723
745,I Feel Pretty,94539426,48795601,45743825,2018.csv,2018,51.61402291568811,48.38597708431189
746,Veteran,94393020,1200627,93192393,2015.csv,2015,1.271944684045494,98.7280553159545
747,Masquerade,94268432,922921,93345511,2012.csv,2012,0.9790350602203716,99.02096493977963
748,Police Story: Lockdown,94249025,0,94249025,2013.csv,2013,0.0,100.0
749,Fleet of Time,94244191,569280,93674911,2014.csv,2014,0.6040478399353016,99.3959521600647
750,Dirty Grandpa,94073028,35593113,58479915,2016.csv,2016,37.8356195784407,62.16438042155931
751,Ben-Hur,94061311,26410477,67650834,2016.csv,2016,28.077938441661736,71.92206155833827
752,Blockers,94017294,60311495,33705799,2018.csv,2018,64.14936277574634,35.85063722425366
753,In the Heart of the Sea,93920758,25020758,68900000,2015.csv,2015,26.640285420183684,73.35971457981631
754,Nothing to Declare,93811164,0,93811164,2011.csv,2011,0.0,100.0
755,Kill Zone 2,93638358,11998,93626360,2015.csv,2015,0.012813125151126635,99.98718687484887
756,The Internship,93492844,44672764,48820080,2013.csv,2013,47.782014204210114,52.217985795789886
757,BlacKkKlansman,93400823,49275340,44125483,2018.csv,2018,52.75685847008008,47.243141529919924
758,Goosebumps 2: Haunted Halloween,93320380,46700633,46619747,2018.csv,2018,50.04333780038187,49.95666219961814
759,Money Monster,93282604,41012075,52270529,2016.csv,2016,43.96540538255129,56.03459461744872
760,Nanny McPhee Returns,93251121,29011215,64239906,2010.csv,2010,31.11084852266816,68.88915147733184
761,Train to Busan,92742323,2129768,90612555,2016.csv,2016,2.2964359001445325,97.70356409985547
762,Southpaw,91970827,52421953,39548874,2015.csv,2015,56.99845778270538,43.00154221729462
763,Get Him to the Greek,91720255,60974475,30745780,2010.csv,2010,66.47874561622184,33.52125438377816
764,Shadow,91708374,521396,91186978,2018.csv,2018,0.5685369582498541,99.43146304175015
765,Season of the Witch,91627228,24827228,66800000,2011.csv,2011,27.09590647007241,72.9040935299276
766,Crawl,91542097,39014193,52527904,2019.csv,2019,42.61885436161682,57.38114563838318
767,Five Feet Apart,91522094,45729221,45792873,2019.csv,2019,49.965225883052895,50.0347741169471
768,Rambo: Last Blood,91490353,44819352,46671001,2019.csv,2019,48.988063255149974,51.011936744850026
769,Overboard,91244913,50316123,40928790,2018.csv,2018,55.1440308787406,44.8559691212594
770,Paranormal Activity: The Marked Ones,90894962,32462372,58432590,2014.csv,2014,35.71415982329141,64.28584017670859
771,My Big Fat Greek Wedding 2,90632641,59689605,30943036,2016.csv,2016,65.85883887020351,34.141161129796494
772,Sherlock Gnomes,90497778,43242871,47254907,2018.csv,2018,47.78335110062039,52.21664889937961
773,Jojo Rabbit,90335025,33370906,56964119,2019.csv,2019,36.941270564767095,63.0587294352329
774,Red Riding Hood,90260376,37662162,52598214,2011.csv,2011,41.72613019028416,58.27386980971584
775,Detective Dee: The Four Heavenly Kings,90040771,262963,89777808,2018.csv,2018,0.29204880975530517,99.7079511902447
776,Sucker Punch,89792502,36392502,53400000,2011.csv,2011,40.52955557469598,59.47044442530402
777,Burlesque,89519773,39440655,50079118,2010.csv,2010,44.05803732321797,55.94196267678203
778,The Hundred-Foot Journey,89514453,54240821,35273632,2014.csv,2014,60.594484110850786,39.40551588914921
779,The Purge,89328627,64473115,24855512,2013.csv,2013,72.17519978226017,27.82480021773983
780,The Last Song,89137047,62950384,26186663,2010.csv,2010,70.62202094265025,29.377979057349744
781,The Inbetweeners,88823111,36000,88787111,2011.csv,2011,0.040529992244923735,99.95947000775509
782,Collateral Beauty,88528280,31016021,57512259,2016.csv,2016,35.0351559976089,64.9648440023911
783,This Is 40,88215156,67544505,20670651,2012.csv,2012,76.56791424820469,23.432085751795302
784,Dhoom 3,88031955,8031955,80000000,2013.csv,2013,9.123908471645324,90.87609152835468
785,Chasing the Dragon,87965942,456854,87509088,2017.csv,2017,0.5193532742478902,99.48064672575211
786,Tiger Zinda Hai,87320000,5560921,81759079,2017.csv,2017,6.368439074667888,93.63156092533211
787,Pain & Gain,87305549,49875291,37430258,2013.csv,2013,57.12728637672274,42.87271362327726
788,Sultan,87280000,6200000,81080000,2016.csv,2016,7.1035747021081574,92.89642529789184
789,A Million Ways to Die in the West,87189756,43139300,44050456,2014.csv,2014,49.477486781818726,50.522513218181274
790,The Thieves,87126367,685839,86440528,2012.csv,2012,0.7871773191231536,99.21282268087684
791,About Time,87100449,15322921,71777528,2013.csv,2013,17.592241114623874,82.40775888537613
792,Dinner for Schmucks,86855739,73026337,13829402,2010.csv,2010,84.07773376955552,15.922266230444485
793,Snowpiercer,86758912,4563650,82195262,2013.csv,2013,5.260151256853014,94.73984874314698
794,The Lincoln Lawyer,86752352,58009200,28743152,2011.csv,2011,66.86758187259292,33.13241812740708
795,Robin Hood,86489031,30824628,55664403,2018.csv,2018,35.63992756491861,64.36007243508139
796,A Taxi Driver,86252940,1527829,84725111,2017.csv,2017,1.7713355625906781,98.22866443740932
797,War Dogs,86234523,43034523,43200000,2016.csv,2016,49.90405408747956,50.09594591252045
798,Step Up All In,86165646,14904384,71261262,2014.csv,2014,17.297362338582133,82.70263766141787
799,Hall Pass,86157237,45060734,41096503,2011.csv,2011,52.300579230506195,47.699420769493805
800,I Can Only Imagine,86086881,83482352,2604529,2018.csv,2018,96.97453436604353,3.025465633956468
801,John Wick,86013056,43037835,42975221,2014.csv,2014,50.03639796265348,49.96360203734652
802,The Second Best Exotic Marigold Hotel,85978266,33078266,52900000,2015.csv,2015,38.472822887588826,61.52717711241118
803,Spy Kids 4-D: All the Time in the World,85564310,38538188,47026122,2011.csv,2011,45.04002661857496,54.95997338142503
804,Paper Towns,85512300,32000304,53511996,2015.csv,2015,37.42187264288295,62.57812735711704
805,The Possession,85446075,49130154,36315921,2012.csv,2012,57.49843278348362,42.501567216516385
806,Nerve,85251425,38583626,46667799,2016.csv,2016,45.25862881470896,54.74137118529103
807,J. Edgar,84920539,37306030,47614509,2011.csv,2011,43.93051485459837,56.06948514540163
808,Going in Style,84918541,45018541,39900000,2017.csv,2017,53.01379471416025,46.98620528583975
809,Sicario,84872444,46889293,37983151,2015.csv,2015,55.24678068655593,44.75321931344406
810,Carrie,84790678,35266619,49524059,2013.csv,2013,41.59256634320108,58.40743365679892
811,The Judge,84419388,47119388,37300000,2014.csv,2014,55.81583699706517,44.184163002934824
812,What to Expect When You're Expecting,84384002,41152203,43231799,2012.csv,2012,48.76777828100639,51.23222171899361
813,Leap!,84197417,2844490,81352927,2016.csv,2016,3.37835779451524,96.62164220548476
814,Finding Mr. Right,84112033,6945,84105088,2013.csv,2013,0.008256844772733052,99.99174315522727
815,Marmaduke,83761844,33644788,50117056,2010.csv,2010,40.16720071253446,59.83279928746554
816,Mortal Engines,83672673,15951040,67721633,2018.csv,2018,19.063619492591087,80.93638050740891
817,Piranha 3D,83188165,25003155,58185010,2010.csv,2010,30.056144404675834,69.94385559532417
818,Oceans,83090556,19422319,63668237,2010.csv,2010,23.374881496761198,76.6251185032388
819,Rings,83080890,27793018,55287872,2017.csv,2017,33.45296132480045,66.54703867519956
820,Savages,82966152,47382068,35584084,2012.csv,2012,57.110118834967786,42.889881165032214
821,Once Upon A Time,82886178,485728,82400450,2017.csv,2017,0.5860180933906736,99.41398190660932
822,"Big Mommas: Like Father, Like Son",82686066,37915414,44770652,2011.csv,2011,45.85465947793429,54.14534052206571
823,Sinister,82515113,48086903,34428210,2012.csv,2012,58.27647960683275,41.72352039316725
824,Act of Valor,82497035,70012847,12484188,2012.csv,2012,84.86710704208946,15.13289295791055
825,Hitman: Agent 47,82347656,22467450,59880206,2015.csv,2015,27.28365455842483,72.71634544157517
826,Abduction,82087155,28087155,54000000,2011.csv,2011,34.21626075358562,65.78373924641437
827,Ouija: Origin of Evil,81705746,35144505,46561241,2016.csv,2016,43.013504827432826,56.986495172567174
828,One Piece: Stampede,81562741,1298528,80264213,2019.csv,2019,1.592060276640286,98.40793972335972
829,Frankenweenie,81491068,35291068,46200000,2012.csv,2012,43.30667012487798,56.693329875122025
830,Tinker Tailor Soldier Spy,81244605,24149393,57095212,2011.csv,2011,29.7243035399089,70.27569646009111
831,Edge of Darkness,81126522,43313890,37812632,2010.csv,2010,53.39054224461884,46.60945775538116
832,Underworld: Blood Wars,81093313,30353973,50739340,2016.csv,2016,37.430919858953104,62.569080141046896
833,A Dog's Way Home,80708134,42004346,38703788,2019.csv,2019,52.044749293794844,47.95525070620515
834,Go Away Mr. Tumor,80606893,286639,80320254,2015.csv,2015,0.3556011022531287,99.64439889774687
835,Vampires Suck,80547866,36661504,43886362,2010.csv,2010,45.51517727359779,54.484822726402214
836,Den of Thieves,80509622,44947622,35562000,2018.csv,2018,55.828882167649475,44.171117832350525
837,Muppets Most Wanted,80383113,51183113,29200000,2014.csv,2014,63.673962216417266,36.32603778358273
838,Hereditary,80200936,44069456,36131480,2018.csv,2018,54.94880508626483,45.05119491373517
839,The Wedding Ringer,79799880,64460211,15339669,2015.csv,2015,80.77732823658381,19.222671763416184
840,The Grey,79781695,51580236,28201459,2012.csv,2012,64.65171741462751,35.348282585372495
841,Letters to Juliet,79293444,53032453,26260991,2010.csv,2010,66.88125817816666,33.11874182183334
842,Manchester by the Sea,78988148,47695371,31292777,2016.csv,2016,60.382946312401195,39.617053687598805
843,Lady Bird,78965611,48958273,30007338,2017.csv,2017,61.99948608008617,38.00051391991382
844,Paranormal Activity: The Ghost Dimension,78903124,18300124,60603000,2015.csv,2015,23.193155191168348,76.80684480883166
845,The Boss,78844582,63285885,15558697,2016.csv,2016,80.26662504216206,19.733374957837942
846,The Attorney,78547586,557236,77990350,2013.csv,2013,0.7094247301247424,99.29057526987526
847,The Family,78418811,36918811,41500000,2013.csv,2013,47.07902418974447,52.92097581025552
848,Scary Movie V,78378744,32015787,46362957,2013.csv,2013,40.84753769465864,59.15246230534136
849,R.I.P.D.,78324220,33618855,44705365,2013.csv,2013,42.92268087700075,57.07731912299925
850,Priest,78309505,29137000,49172505,2011.csv,2011,37.20748841408204,62.79251158591796
851,If I Stay,78274843,50474843,27800000,2014.csv,2014,64.4841191185781,35.51588088142189
852,Tag,78130625,54730625,23400000,2018.csv,2018,70.05015638874002,29.94984361125999
853,Shin Godzilla,77947607,1918403,76029204,2016.csv,2016,2.461144188813904,97.5388558111861
854,Tiny Times,77717014,23462,77693552,2013.csv,2013,0.030189013695250823,99.96981098630475
855,The Back-up Plan,77477008,37490007,39987001,2010.csv,2010,48.38855806099275,51.61144193900725
856,Diary of a Wimpy Kid: Dog Days,77229695,49008662,28221033,2012.csv,2012,63.45831354118386,36.54168645881613
857,Mike and Dave Need Wedding Dates,77068246,46009673,31058573,2016.csv,2016,59.699909350473604,40.300090649526396
858,Drive,76976666,35061555,41915111,2011.csv,2011,45.5482899194413,54.451710080558705
859,"I, Frankenstein",76801179,19075290,57725889,2014.csv,2014,24.8372358971208,75.1627641028792
860,Sanju,76693052,7909317,68783735,2018.csv,2018,10.312951165380666,89.68704883461933
861,The Book Thief,76586316,21488481,55097835,2013.csv,2013,28.057859578987976,71.94214042101203
862,Cold Pursuit,76419755,32138862,44280893,2019.csv,2019,42.055698817668286,57.944301182331714
863,The Ides of March,76338111,40962534,35375577,2011.csv,2011,53.65934978401549,46.34065021598452
864,Kubo and the Two Strings,76249438,48023088,28226350,2016.csv,2016,62.981563221488926,37.018436778511074
865,Diary of a Wimpy Kid,76196538,64003625,12192913,2010.csv,2010,83.99807482066967,16.001925179330325
866,The Mechanic,76130093,29121498,47008595,2011.csv,2011,38.25228218229025,61.74771781770975
867,If You Are the One 2,76085443,426894,75658549,2010.csv,2010,0.5610718465554574,99.43892815344454
868,Vice,76073488,47836282,28237206,2018.csv,2018,62.88167304751426,37.11832695248573
869,Widows,75984700,42402632,33582068,2018.csv,2018,55.80417110286676,44.19582889713324
870,Sicario: Day of the Soldado,75837743,50072235,25765508,2018.csv,2018,66.02548153364744,33.97451846635256
871,A Dog's Journey,75727748,22782371,52945377,2019.csv,2019,30.084574811335997,69.915425188664
872,Bajrangi Bhaijaan,75547184,8178001,67369183,2015.csv,2015,10.825024265629809,89.1749757343702
873,Searching,75462037,26020957,49441080,2018.csv,2018,34.48218208050758,65.51781791949242
874,The Change-Up,75450437,37081475,38368962,2011.csv,2011,49.14679950760259,50.85320049239741
875,The Spy Who Dumped Me,75320680,33562069,41758611,2018.csv,2018,44.55890334500432,55.44109665499568
876,Larry Crowne,75055070,35608245,39446825,2011.csv,2011,47.44282431553258,52.55717568446742
877,Easy A,75026216,58401464,16624752,2010.csv,2010,77.84140946146077,22.158590538539222
878,Tyler Perry's Boo! A Madea Halloween,74827344,73206343,1621001,2016.csv,2016,97.8336782874453,2.1663217125547045
879,A Madea Family Funeral,74747725,73257045,1490680,2019.csv,2019,98.00571856869223,1.9942814313077755
880,Crimson Peak,74679822,31090320,43589502,2014.csv,2014,41.63148648104705,58.368513518952945
881,Escape from Planet Earth,74597643,57012977,17584666,2013.csv,2013,76.42731687916735,23.572683120832654
882,Hubble 3D,74249729,52522904,21726825,2010.csv,2010,70.73817602755156,29.261823972448436
883,August: Osage County,74188937,37738810,36450127,2013.csv,2013,50.86851426379111,49.13148573620889
884,Miracles from Heaven,73983003,61705123,12277880,2016.csv,2016,83.40445845378837,16.595541546211635
885,Cats,73834284,27166770,46667514,2019.csv,2019,36.79424859053282,63.20575140946718
886,Charlie's Angels,73279888,17803077,55476811,2019.csv,2019,24.294629107511735,75.70537089248826
887,War Room,73267874,67790117,5477757,2015.csv,2015,92.52365777666758,7.476342223332426
888,To Rome With Love,73244881,16685867,56559014,2012.csv,2012,22.780932636097805,77.2190673639022
889,Here Comes the Boom,73100172,45290318,27809854,2012.csv,2012,61.95651359069305,38.043486409306944
890,The Best Man Holiday,72835710,70525195,2310515,2013.csv,2013,96.82777170703766,3.1722282929623398
891,The Transporter Refueled,72629670,16029670,56600000,2015.csv,2015,22.070415575342693,77.9295844246573
892,Diary of a Wimpy Kid: Rodrick Rules,72526996,52698535,19828461,2011.csv,2011,72.66057868989914,27.339421310100864
893,Doctor Sleep,72381712,31581712,40800000,2019.csv,2019,43.63217051290525,56.36782948709475
894,Second Act,72282227,39282227,33000000,2018.csv,2018,54.345623579085355,45.654376420914645
895,What Men Want,72216294,54611903,17604391,2019.csv,2019,75.62268841987377,24.377311580126225
896,Run All Night,71561644,26461644,45100000,2015.csv,2015,36.97741208963841,63.022587910361594
897,Brick Mansions,71416730,20396829,51019901,2014.csv,2014,28.560295325759107,71.4397046742409
898,The Counselor,71009334,16973715,54035619,2013.csv,2013,23.903498376706363,76.09650162329363
899,Son of God,70829270,59700064,11129206,2014.csv,2014,84.2872784090532,15.712721590946794
900,I Am Not Madame Bovary,70826207,436798,70389409,2016.csv,2016,0.6167180461887505,99.38328195381125
901,Spirited Away 2018 Re-release,70186029,1175067,69010962,2018.csv,2018,1.6742178133485794,98.32578218665142
902,Think Like a Man Too,70181428,65182182,4999246,2014.csv,2014,92.8766824180323,7.123317581967696
903,The Cabin in the Woods,69935600,42073277,27862323,2012.csv,2012,60.160028654933974,39.83997134506603
904,After,69746452,12138565,57607887,2019.csv,2019,17.403845861578738,82.59615413842127
905,The Dilemma,69721966,48475290,21246676,2011.csv,2011,69.52656785380952,30.473432146190483
906,Exit,69501772,470699,69031073,2019.csv,2019,0.6772474808268197,99.32275251917318
907,The Last Exorcism,69432527,41034350,28398177,2010.csv,2010,59.099606154331674,40.900393845668326
908,13 Hours,69411370,52853219,16558151,2015.csv,2015,76.14490104431017,23.855098955689826
909,Finding Nemo 2012 3D Release,69328283,41128283,28200000,2012.csv,2012,59.32396017942634,40.67603982057366
910,Takers,69055695,57744720,11310975,2010.csv,2010,83.62050371080907,16.37949628919092
911,Anna Karenina,68929150,12816367,56112783,2012.csv,2012,18.593536986891614,81.4064630131084
912,Running Man,68782475,310978,68471497,2015.csv,2015,0.4521180722269735,99.54788192777303
913,The Nut Job 2: Nutty by Nature,68743485,28370522,40372963,2017.csv,2017,41.270124725273966,58.72987527472603
914,Playing with Fire,68631669,44451847,24179822,2019.csv,2019,64.76871049136224,35.23128950863777
915,The Call,68572631,51872378,16700253,2013.csv,2013,75.64589143444124,24.354108565558757
916,One Direction: This Is Us,68532898,28873374,39659524,2013.csv,2013,42.13067715303678,57.86932284696322
917,Stalingrad,68316452,1013945,67302507,2013.csv,2013,1.4841886109659208,98.51581138903408
918,The Watch,68267862,35353000,32914862,2012.csv,2012,51.78571433802922,48.21428566197078
919,Moonrise Kingdom,68263166,45512466,22750700,2012.csv,2012,66.67207026407185,33.32792973592816
920,Shoplifters,67999335,3313513,64685822,2018.csv,2018,4.872860889007223,95.12713911099277
921,Legion,67918658,40168080,27750578,2010.csv,2010,59.141451234210194,40.85854876578981
922,The American,67876281,35606376,32269905,2010.csv,2010,52.45775913975016,47.54224086024984
923,A Beautiful Day in the Neighborhood,67760877,61704055,6056822,2019.csv,2019,91.06147637374882,8.938523626251177
924,Jersey Boys,67647013,47047013,20600000,2014.csv,2014,69.54780545890475,30.452194541095256
925,12 Strong,67450815,45819713,21631102,2018.csv,2018,67.93055502739293,32.06944497260707
926,The Next Three Days,67448651,21148651,46300000,2010.csv,2010,31.35518751887269,68.64481248112732
927,American Assassin,67234188,36249674,30984514,2017.csv,2017,53.915537732083564,46.084462267916436
928,War,67179155,4654000,62525155,2019.csv,2019,6.927744178979328,93.07225582102068
929,Skyline,66984887,21393620,45591267,2010.csv,2010,31.937980279044137,68.06201972095586
930,The Giver,66980456,45090374,21890082,2014.csv,2014,67.31870263767688,32.68129736232312
931,Madea's Witness Protection,66899242,65653242,1246000,2012.csv,2012,98.13749758181116,1.8625024181888339
932,Mulan,66800000,0,66800000,2020.csv,2020,0.0,100.0
933,Selma,66787908,52076908,14711000,2014.csv,2014,77.9735577284439,22.0264422715561
934,Victoria & Abdul,66558465,22245070,44313395,2017.csv,2017,33.42184949728033,66.57815050271968
935,"Love, Simon",66316289,40826341,25489948,2018.csv,2018,61.563066353124796,38.436933646875204
936,Mile 22,66308758,36108758,30200000,2018.csv,2018,54.45548836851989,45.54451163148011
937,One Piece Film: Gold,66207073,423593,65783480,2016.csv,2016,0.639800221949096,99.36019977805091
938,Life of the Party,65859911,53059911,12800000,2018.csv,2018,80.56480823364612,19.435191766353892
939,Beijing Love Story,65842375,428318,65414057,2014.csv,2014,0.6505202766455493,99.34947972335445
940,The Age of Adaline,65663276,42629776,23033500,2015.csv,2015,64.92179281460157,35.078207185398426
941,Moonlight,65336603,27854932,37481671,2016.csv,2016,42.63296639404409,57.36703360595592
942,Something Borrowed,65100369,39046489,26053880,2011.csv,2011,59.97890580312993,40.02109419687007
943,The Pirates,64858224,415775,64442449,2014.csv,2014,0.6410520892462304,99.35894791075377
944,Hot Tub Time Machine,64735752,50287556,14448196,2010.csv,2010,77.68127262969,22.318727370309997
945,God's Not Dead,64667874,60755732,3912142,2014.csv,2014,93.95040882277961,6.0495911772203925
946,The Darkest Hour,64626786,21443494,43183292,2011.csv,2011,33.18050506178661,66.81949493821338
947,Happy Death Day 2U,64600152,28148130,36452022,2019.csv,2019,43.57285413198409,56.42714586801591
948,Monster Trucks,64493915,33370166,31123749,2016.csv,2016,51.74157282900255,48.25842717099745
949,Capernaum,64417003,1661096,62755907,2018.csv,2018,2.5786607923997953,97.4213392076002
950,Fences,64414761,57682904,6731857,2016.csv,2016,89.54920130806664,10.45079869193336
951,Zhongkui: Snow Girl and the Dark Crystal,64325947,165428,64160519,2015.csv,2015,0.2571714956641058,99.74282850433589
952,Isle of Dogs,64241499,32015231,32226268,2018.csv,2018,49.83574713908839,50.16425286091161
953,Thunder and the House of Magic,64197205,4091,64193114,2013.csv,2013,0.00637255157759594,99.9936274484224
954,The Danish Girl,64191523,11114018,53077505,2015.csv,2015,17.31384064528271,82.68615935471729
955,The Boy,64188367,35819556,28368811,2015.csv,2015,55.803812550644885,44.196187449355115
956,The Grandmaster,64076736,6594959,57481777,2013.csv,2013,10.292282990194757,89.70771700980524
957,Hanna,63782078,40259119,23522959,2011.csv,2011,63.119798323284485,36.880201676715515
958,"Hail, Caesar!",63647656,30498085,33149571,2016.csv,2016,47.91705919225054,52.082940807749466
959,Elite Squad 2: The Enemy Within,63618850,100119,63518731,2010.csv,2010,0.15737316848701288,99.84262683151299
960,Footloose 2011 Re-release,63543328,51802742,11740586,2011.csv,2011,81.52349527553861,18.476504724461396
961,Conan the Barbarian,63523283,21295021,42228262,2011.csv,2011,33.523174487061695,66.47682551293829
962,Begin Again,63464861,16170632,47294229,2014.csv,2014,25.479661887229216,74.52033811277077
963,Colombiana,63458440,36665854,26792586,2011.csv,2011,57.77931824356224,42.220681756437756
964,Side Effects,63414135,32172757,31241378,2013.csv,2013,50.73436229950941,49.26563770049059
965,The Host,63365859,26627201,36738658,2013.csv,2013,42.021368320754554,57.97863167924544
966,The Longest Ride,62944815,37446117,25498698,2015.csv,2015,59.49039170263667,40.50960829736333
967,Unfriended,62882090,32482090,30400000,2015.csv,2015,51.65555088897331,48.344449111026684
968,The Mountain Between Us,62832209,30348555,32483654,2017.csv,2017,48.30095182551993,51.69904817448007
969,The Star,62812974,40852824,21960150,2017.csv,2017,65.038830990553,34.961169009447
970,The Nice Guys,62788218,36261763,26526455,2016.csv,2016,57.752495858379035,42.247504141620965
971,Beauty and the Beast 2012 3D Release,62767829,47617067,15150762,2012.csv,2012,75.86221757008674,24.13778242991326
972,Devil,62695489,33601190,29094299,2010.csv,2010,53.59427055429777,46.40572944570223
973,Runner Runner,62675095,19316646,43358449,2013.csv,2013,30.82028994132358,69.17971005867642
974,How to Be a Latin Lover,62547032,32149404,30397628,2017.csv,2017,51.40036700702281,48.599632992977185
975,Andhadhun,62475342,1193046,61282296,2018.csv,2018,1.9096270013215775,98.09037299867842
976,47 Meters Down,62187529,44307191,17880338,2017.csv,2017,71.24771109654478,28.752288903455224
977,Brooklyn,62076141,38322743,23753398,2015.csv,2015,61.73506017392415,38.26493982607585
978,"Dragon Ball Z: Resurrection ""F""",61768190,8008363,53759827,2015.csv,2015,12.96518968744268,87.03481031255733
979,White Snake,61631776,34730,61597046,2019.csv,2019,0.0563508018980339,99.94364919810197
980,"Everything, Everything",61621140,34121140,27500000,2017.csv,2017,55.37245821807256,44.62754178192744
981,Woman in Gold,61619773,33307793,28311980,2015.csv,2015,54.0537418078447,45.9462581921553
982,The Face Reader,61559184,515876,61043308,2013.csv,2013,0.8380163063889865,99.161983693611
983,Krampus,61548707,42725475,18823232,2015.csv,2015,69.4173396688902,30.5826603311098
984,From Up on Poppy Hill,61459425,1002895,60456530,2011.csv,2011,1.63180016734618,98.36819983265383
985,Bombshell,61404394,31762808,29641586,2019.csv,2019,51.727255870320946,48.272744129679054
986,The Legend of Hercules,61279452,18848538,42430914,2013.csv,2013,30.758333152195945,69.24166684780405
987,Ashfall,61255955,372562,60883393,2019.csv,2019,0.6082053573403599,99.39179464265963
988,The Walk,61181942,10137502,51044440,2014.csv,2014,16.569434817874857,83.43056518212515
989,Ma,61105672,45896028,15209644,2019.csv,2019,75.10927627144007,24.890723728559927
990,Snatched,60845711,45852178,14993533,2017.csv,2017,75.35811028652455,24.641889713475447
991,Kick-Ass 2,60795985,28795985,32000000,2013.csv,2013,47.36494523445915,52.63505476554084
992,127 Hours,60738797,18335230,42403567,2010.csv,2010,30.187015393143202,69.8129846068568
993,Why Did I Get Married Too?,60673972,60095852,578120,2010.csv,2010,99.04716968257821,0.9528303174217769
994,Evangelion: 3.0 You Can (Not) Redo,60488344,174945,60313399,2012.csv,2012,0.28922101091079633,99.71077898908919
995,The Ghost Writer,60331447,15541549,44789898,2010.csv,2010,25.760278880763458,74.23972111923653
996,My Little Pony: The Movie,60330833,21885107,38445726,2017.csv,2017,36.27516132588456,63.72483867411544
997,Secretariat,60321861,59713955,607906,2010.csv,2010,98.99222936772458,1.00777063227542
998,The Perfect Guy,60273173,57027435,3245738,2015.csv,2015,94.61495415215654,5.385045847843451
999,A Haunted House,60159584,40041683,20117901,2013.csv,2013,66.55910885288037,33.440891147119636
1000,Beautiful Creatures,60052138,19452138,40600000,2013.csv,2013,32.3920823601651,67.60791763983491
1001,Morning Glory,60040976,31011732,29029244,2010.csv,2010,51.65094584738262,48.34905415261737
1002,Forever Young,59981902,149761,59832141,2015.csv,2015,0.24967697756566637,99.75032302243433
1003,Adrift,59945012,31445012,28500000,2018.csv,2018,52.45642790095696,47.54357209904303
1004,Quartet,59520298,18390117,41130181,2012.csv,2012,30.897219298196386,69.10278070180361
1005,Rock of Ages,59418613,38518613,20900000,2012.csv,2012,64.82583664482374,35.17416335517626
1006,Miss Granny,59396311,234573,59161738,2015.csv,2015,0.3949285671967069,99.6050714328033
1007,One Day,59389433,13843771,45545662,2011.csv,2011,23.310158559688556,76.68984144031144
1008,Molly's Game,59284015,28780744,30503271,2017.csv,2017,48.54722474515263,51.45277525484736
1009,The Devotion of Suspect X,59035664,686435,58349229,2017.csv,2017,1.1627463019641822,98.83725369803582
1010,The Gift,58978653,43787265,15191388,2015.csv,2015,74.2425653566554,25.757434643344602
1011,A Walk Among the Tombstones,58834384,26307600,32526784,2014.csv,2014,44.714668891578775,55.28533110842122
1012,Shock Wave,58815633,0,58815633,2017.csv,2017,0.0,100.0
1013,The Tree of Life,58409247,13303319,45105928,2011.csv,2011,22.77604948408255,77.22395051591745
1014,Beginning of the Great Revival,58309289,151000,58158289,2011.csv,2011,0.2589638848108746,99.74103611518913
1015,Huo guo ying xiong,58106427,779818,57326609,2016.csv,2016,1.3420511985705126,98.65794880142948
1016,L.O.R.D: Legend of Ravaging Dynasties,58089494,350456,57739038,2016.csv,2016,0.603303585326462,99.39669641467354
1017,Snitch,57824674,42930462,14894212,2013.csv,2013,74.2424626553018,25.757537344698218
1018,Dolphin Tale 2,57824533,42024533,15800000,2014.csv,2014,72.67595745217692,27.324042547823087
1019,Nine Lives,57814445,19700032,38114413,2016.csv,2016,34.07458464748732,65.92541535251269
1020,That's My Boy,57719093,36931089,20788004,2012.csv,2012,63.984181109706626,36.015818890293374
1021,Goldbuster,57628292,186135,57442157,2017.csv,2017,0.3229923940831007,99.6770076059169
1022,Ready or Not,57615777,28714231,28901546,2019.csv,2019,49.83744469852416,50.16255530147584
1023,Killer Elite,57084522,25124966,31959556,2011.csv,2011,44.013622466699466,55.986377533300534
1024,The 15:17 to Paris,57076286,36276286,20800000,2018.csv,2018,63.55754472181319,36.44245527818681
1025,All the Money in the World,56996304,25113707,31882597,2017.csv,2017,44.061992160053045,55.938007839946955
1026,Zoolander 2,56722693,28848693,27874000,2016.csv,2016,50.85917377018754,49.14082622981247
1027,The Big Sick,56411585,42873127,13538458,2017.csv,2017,76.00057151381228,23.99942848618772
1028,Remember Me,56032889,19068240,36964649,2010.csv,2010,34.030442371086735,65.96955762891326
1029,The Odd Life of Timothy Green,56012642,51854875,4157767,2012.csv,2012,92.57709179295631,7.4229082070436885
1030,Confidential Assignment,55972241,475618,55496623,2017.csv,2017,0.8497390697649573,99.15026093023505
1031,Dallas Buyers Club,55736588,27298285,28438303,2013.csv,2013,48.977316300739474,51.022683699260526
1032,All Eyez on Me,55668698,44922302,10746396,2017.csv,2017,80.6958014358446,19.30419856415539
1033,Cop Out,55611001,44875481,10735520,2010.csv,2010,80.69533040773713,19.30466959226287
1034,Lawless,55404159,37400127,18004032,2012.csv,2012,67.50418682467502,32.495813175324976
1035,Silent Hill: Revelation,55362705,17529157,37833548,2011.csv,2011,31.662392579986836,68.33760742001317
1036,Extremely Loud & Incredibly Close,55247881,31847881,23400000,2011.csv,2011,57.64543440136646,42.35456559863355
1037,End of Watch,55078146,41003371,14074775,2012.csv,2012,74.4458083247755,25.55419167522451
1038,Hellboy,55064690,21903748,33160942,2019.csv,2019,39.77820995632592,60.22179004367408
1039,Barbershop: The Next Cut,55030051,54030051,1000000,2016.csv,2016,98.18281106081476,1.8171889391852463
1040,Downsizing,55003890,24449754,30554136,2017.csv,2017,44.45095428705134,55.54904571294866
1041,St. Vincent,54837234,44137712,10699522,2014.csv,2014,80.48858190039272,19.511418099607287
1042,The Three Stooges,54819301,44338224,10481077,2012.csv,2012,80.88068105793614,19.119318942063853
1043,The Crazies,54806823,39123589,15683234,2010.csv,2010,71.38452268981182,28.615477310188187
1044,Early Man,54622814,8267544,46355270,2018.csv,2018,15.135697695838227,84.86430230416178
1045,The Age of Shadows,54491162,541719,53949443,2016.csv,2016,0.9941410315309481,99.00585896846906
1046,No Escape,54418872,27288872,27130000,2015.csv,2015,50.14597141962075,49.85402858037925
1047,No Good Deed,54323210,52543632,1779578,2014.csv,2014,96.72409270365281,3.275907296347178
1048,The Five-Year Engagement,54169363,28835528,25333835,2012.csv,2012,53.23217110749484,46.76782889250516
1049,Tyler Perry's Madea's Big Happy Family,54161287,53345287,816000,2011.csv,2011,98.49338882955274,1.5066111704472605
1050,"I, Tonya",53939297,30014539,23924758,2017.csv,2017,55.64503185868366,44.35496814131634
1051,Peppermint,53918723,35418723,18500000,2018.csv,2018,65.68909838610236,34.31090161389764
1052,Long Shot,53873809,30316271,23557538,2019.csv,2019,56.27274470234692,43.72725529765308
1053,Tyler Perry's A Madea Christmas,53396635,52543354,853281,2013.csv,2013,98.40199480735069,1.598005192649312
1054,Sinister 2,53329150,27740955,25588195,2015.csv,2015,52.01837081596088,47.98162918403912
1055,Little White Lies,53319615,206088,53113527,2010.csv,2010,0.3865144187556493,99.61348558124435
1056,3 Days to Kill,53260230,30697999,22562231,2014.csv,2014,57.63775147046868,42.36224852953132
1057,Temptation: Confessions of a Marriage Counselor,53143144,51975354,1167790,2013.csv,2013,97.80255756038822,2.1974424396117778
1058,Delivery Man,53120346,30664106,22456240,2013.csv,2013,57.72572716299702,42.27427283700298
1059,From Paris with Love,52830951,24077427,28753524,2010.csv,2010,45.57447205521627,54.42552794478374
1060,Found a Treasure Called Love,52715771,4364639,48351132,2015.csv,2015,8.279569694617575,91.72043030538242
1061,Wild,52501541,37880356,14621185,2014.csv,2014,72.15094124570554,27.84905875429447
1062,Teo-neol,52444295,568876,51875419,2016.csv,2016,1.0847242774452397,98.91527572255477
1063,The Boy Next Door,52425855,35423380,17002475,2015.csv,2015,67.5685308327351,32.43146916726489
1064,The Night Before,52395996,43047372,9348624,2015.csv,2015,82.15775113808314,17.842248861916854
1065,Patriots Day,52185751,31886361,20299390,2016.csv,2016,61.10166163940038,38.898338360599624
1066,The Finest Hours,52099090,27569558,24529532,2016.csv,2016,52.917542321756486,47.082457678243514
1067,Teen Titans GO! To the Movies,52090236,29790236,22300000,2018.csv,2018,57.18967370391641,42.81032629608359
1068,Detective Dee: Mystery of the Phantom Flame,51899269,459836,51439433,2010.csv,2010,0.8860163329082728,99.11398366709173
1069,"Yo-kai Watch Movie: It's the Secret of Birth, Meow!",51838845,257343,51581502,2015.csv,2015,0.4964288845555876,99.50357111544442
1070,Slender Man,51738549,30569484,21169065,2018.csv,2018,59.08454061979975,40.91545938020025
1071,Master,51636415,597251,51039164,2016.csv,2016,1.1566469128424195,98.84335308715758
1072,Daybreakers,51416464,30101577,21314887,2010.csv,2010,58.54462687282423,41.45537312717576
1073,Breaking In,51411620,46840590,4571030,2018.csv,2018,91.10895552406247,8.89104447593754
1074,Hot Pursuit,51380201,34580201,16800000,2015.csv,2015,67.30258022929883,32.69741977070117
1075,Simmba,51329025,5102129,46226896,2018.csv,2018,9.9400465915727,90.05995340842729
1076,Once Upon a Deadpool 2018 Re-release,51247568,6100309,45147259,2018.csv,2018,11.903606820912946,88.09639317908704
1077,The 100 Year-Old Man Who Climbed Out the Window and Disappeared,51167572,944193,50223379,2013.csv,2013,1.8452956884489262,98.15470431155107
1078,Magic in the Moonlight,51029361,10539326,40490035,2014.csv,2014,20.653454782629947,79.34654521737005
1079,Red Dawn,50950296,44806783,6143513,2012.csv,2012,87.94214463444922,12.05785536555077
1080,War of the Arrows,50587661,251200,50336461,2011.csv,2011,0.49656377668854856,99.50343622331145
1081,The Himalayas,50544493,696717,49847776,2015.csv,2015,1.3784231647154914,98.62157683528451
1082,Alpha and Omega,50507267,25107267,25400000,2010.csv,2010,49.710207048027364,50.289792951972636
1083,Dragon Ball Z: Battle of Gods,50461371,2553002,47908369,2013.csv,2013,5.059319533747904,94.94068046625209
1084,About Last Night,50445860,48637684,1808176,2014.csv,2014,96.41561071612219,3.584389283877805
1085,Breakthrough,50444358,40713082,9731276,2019.csv,2019,80.70889117074303,19.29110882925698
1086,Just Mercy,50401502,36001502,14400000,2019.csv,2019,71.4294228771198,28.570577122880188
1087,Red Tails,50365498,49876377,489121,2012.csv,2012,99.02885701636465,0.9711429836353449
1088,"Monsters, Inc. 2012 3D Release",50207820,34043006,16164814,2012.csv,2012,67.80419066193274,32.19580933806726
1089,Uncut Gems,50023780,50023780,0,2019.csv,2019,100.0,0.0
1090,21 Bridges,49939757,28539757,21400000,2019.csv,2019,57.14836978481894,42.85163021518106
1091,Winnie the Pooh,49871429,26692846,23178583,2011.csv,2011,53.5233229430823,46.4766770569177
1092,The Wailing,49851770,786633,49065137,2016.csv,2016,1.5779439727014708,98.42205602729854
1093,The Switch,49830607,27779426,22051181,2010.csv,2010,55.747717462081084,44.252282537918916
1094,She's Out of My League,49779728,32010860,17768868,2010.csv,2010,64.30501187149918,35.69498812850082
1095,The Boy and the Beast,49714378,490643,49223735,2015.csv,2015,0.9869237426645466,99.01307625733546
1096,Vanguard,49656971,0,49656971,2020.csv,2020,0.0,100.0
1097,Surprise,49567466,0,49567466,2015.csv,2015,0.0,100.0
1098,Death Wish,49562710,34017028,15545682,2018.csv,2018,68.63431801852643,31.36568198147357
1099,The Grudge,49511319,21221803,28289516,2019.csv,2019,42.86252806151256,57.13747193848744
1100,Entourage,49263404,32363404,16900000,2015.csv,2015,65.69461582476112,34.305384175238885
1101,Death at a Funeral,49050886,42739347,6311539,2010.csv,2010,87.13267075338862,12.867329246611368
1102,Little,48987096,40860481,8126615,2019.csv,2019,83.41070268790786,16.589297312092146
1103,Whiplash,48982041,13092000,35890041,2014.csv,2014,26.72816349159481,73.2718365084052
1104,Zhi qing chun 2: Yuan lai ni hai zai zhe li,48980792,96421,48884371,2016.csv,2016,0.19685471806989158,99.8031452819301
1105,The Berlin File,48972848,665210,48307638,2013.csv,2013,1.3583241064518037,98.6416758935482
1106,Trouble with the Curve,48963137,35763137,13200000,2012.csv,2012,73.04094302617906,26.95905697382094
1107,Luck-Key,48913975,466505,48447470,2016.csv,2016,0.9537253923853051,99.04627460761469
1108,Florence Foster Jenkins,48902953,27383770,21519183,2016.csv,2016,55.996148126269595,44.003851873730405
1109,The Woman in Black 2: Angel of Death,48854305,26501323,22352982,2015.csv,2015,54.24562482262311,45.7543751773769
1110,Fantasy Island,48811343,27309289,21502054,2020.csv,2020,55.94865316449088,44.051346835509115
1111,Isn't It Romantic,48791187,48791187,0,2019.csv,2019,100.0,0.0
1112,Mother's Day,48782670,32492859,16289811,2016.csv,2016,66.60738126879893,33.392618731201054
1113,How Do You Know,48668907,30212620,18456287,2010.csv,2010,62.077868319500176,37.92213168049983
1114,Concussion,48623572,34542474,14081098,2015.csv,2015,71.04059323325733,28.959406766742685
1115,Her,48517427,25568251,22949176,2013.csv,2013,52.69910747740189,47.30089252259811
1116,Logan Lucky,48453605,27780977,20672628,2017.csv,2017,57.33521169374291,42.66478830625709
1117,Homefront,48449416,20158898,28290518,2013.csv,2013,41.608134141389854,58.391865858610146
1118,Chef,48428048,31424003,17004045,2014.csv,2014,64.88802315550691,35.11197684449309
1119,Boo 2! A Madea Halloween,48333932,47319572,1014360,2017.csv,2017,97.9013501322425,2.0986498677575
1120,The Last Stand,48330757,12050299,36280458,2013.csv,2013,24.932982117370933,75.06701788262907
1121,Charlie St. Cloud,48190704,31162545,17028159,2010.csv,2010,64.66505448851713,35.33494551148288
1122,Arthur,48147945,33035397,15112548,2011.csv,2011,68.61226787560715,31.387732124392848
1123,Boyhood,48137666,25352281,22785385,2014.csv,2014,52.66620321807874,47.33379678192125
1124,21 & Over,48065672,25682380,22383292,2013.csv,2013,53.431854650861844,46.56814534913815
1125,Heartbreaker,48023509,504030,47519479,2010.csv,2010,1.0495484617752526,98.95045153822475
1126,Countdown,48021766,25621766,22400000,2019.csv,2019,53.35448513076341,46.645514869236585
1127,After We Collided,47984832,2380901,45603931,2020.csv,2020,4.961778338621671,95.03822166137833
1128,Midsommar,47863365,27426361,20437004,2019.csv,2019,57.301363997286856,42.698636002713144
1129,Queen & Slim,47802566,43808310,3994256,2019.csv,2019,91.64426445224719,8.355735547752813
1130,Phantom Thread,47756590,21198205,26558385,2017.csv,2017,44.38802058522185,55.61197941477815
1131,Scott Pilgrim vs. the World,47664559,31524275,16140284,2010.csv,2010,66.13776705665104,33.86223294334896
1132,Man on a Ledge,47636031,18620000,29016031,2012.csv,2012,39.08805920459662,60.911940795403375
1133,Coming Home,47587984,377607,47210377,2014.csv,2014,0.7934923236084135,99.20650767639158
1134,47 Meters Down: Uncaged,47582563,22260900,25321663,2019.csv,2019,46.783734621441056,53.216265378558944
1135,Beauty and the Beast,47430624,0,47430624,2014.csv,2014,0.0,100.0
1136,Nightcrawler,47398992,32381217,15017775,2014.csv,2014,68.3162565988745,31.68374340112549
1137,Rough Night,47347283,22105643,25241640,2017.csv,2017,46.6883031070653,53.3116968929347
1138,Texas Chainsaw,47340586,34341945,12998641,2013.csv,2013,72.54228961170865,27.45771038829135
1139,A Monster Calls,47309313,3740823,43568490,2016.csv,2016,7.907159843982516,92.09284015601749
1140,Tiny Times 2.0,47289937,43788,47246149,2013.csv,2013,0.09259475224084143,99.90740524775916
1141,Golden Job,47287851,285795,47002056,2018.csv,2018,0.6043729921243407,99.39562700787566
1142,Mortdecai,47275695,7696134,39579561,2015.csv,2015,16.279261468287245,83.72073853171275
1143,Soul Surfer,47120948,43853424,3267524,2011.csv,2011,93.06566582658736,6.9343341734126405
1144,The Place Beyond the Pines,47052899,21403519,25649380,2013.csv,2013,45.48820466938711,54.51179533061289
1145,Son of Bigfoot,47046281,289308,46756973,2017.csv,2017,0.6149434000957483,99.38505659990426
1146,Parker,46922566,17616641,29305925,2013.csv,2013,37.54406994706982,62.455930052930185
1147,Mary Queen of Scots,46712809,16468499,30244310,2018.csv,2018,35.25478204489907,64.74521795510093
1148,Uncle Drew,46664414,42469946,4194468,2018.csv,2018,91.01142039413588,8.988579605864118
1149,The Big Wedding,46522137,21819348,24702789,2013.csv,2013,46.90100112984922,53.09899887015078
1150,Risen,46432579,36880033,9552546,2016.csv,2016,79.42706133122608,20.572938668773926
1151,Tyler Perry's Acrimony,46403669,43549096,2854573,2018.csv,2018,93.84838944523977,6.151610554760229
1152,A Werewolf Boy,46282588,342922,45939666,2012.csv,2012,0.7409309090494248,99.25906909095058
1153,The Thousand Faces of Dunjia,46263237,124187,46139050,2017.csv,2017,0.2684356047113608,99.73156439528864
1154,Asterix: The Secret of the Magic Potion,46221204,1271953,44949251,2018.csv,2018,2.7518820150163115,97.24811798498368
1155,The Battleship Island,46183383,1104957,45078426,2017.csv,2017,2.392542356630739,97.60745764336927
1156,Eddie the Eagle,46152800,15789389,30363411,2016.csv,2016,34.2111182853478,65.7888817146522
1157,The World's End,46089287,26004851,20084436,2013.csv,2013,56.42276696534707,43.577233034652934
1158,Let's Get Married,45972724,462918,45509806,2015.csv,2015,1.0069405502271302,98.99305944977287
1159,The New Mutants,45863139,23771361,22091778,2020.csv,2020,51.83108160128334,48.16891839871667
1160,Avatar 2010 Special Edition,45823494,10741486,35082008,2010.csv,2010,23.441001683546872,76.55899831645313
1161,Somewhere Only We Know,45737711,482341,45255370,2015.csv,2015,1.0545805407708313,98.94541945922917
1162,Chasing the Dragon II: Wild Wild Bunch,45733356,196634,45536722,2019.csv,2019,0.42995751284904615,99.57004248715096
1163,"McFarland, USA",45710059,44482410,1227649,2015.csv,2015,97.31426949153577,2.685730508464231
1164,Earth to Echo,45681062,38934842,6746220,2014.csv,2014,85.23191076424624,14.768089235753756
1165,That Awkward Moment,45640143,26068955,19571188,2014.csv,2014,57.11847791537375,42.88152208462625
1166,The Debt,45636368,31177548,14458820,2011.csv,2011,68.31732972264575,31.682670277354237
1167,Hero,45565534,88675,45476859,2015.csv,2015,0.19460981188105905,99.80539018811893
1168,Machete,45491656,26593646,18898010,2010.csv,2010,58.45829397813085,41.54170602186915
1169,Love on the Cloud,45386560,271734,45114826,2014.csv,2014,0.5987102789900799,99.40128972100992
1170,Blair Witch,45173154,20777061,24396093,2016.csv,2016,45.99426686035693,54.00573313964308
1171,Flatliners,45158254,16883115,28275139,2017.csv,2017,37.38655396198445,62.61344603801555
1172,Grudge Match,44907260,29807260,15100000,2013.csv,2013,66.37514735924658,33.62485264075341
1173,Child's Play,44907074,29208403,15698671,2019.csv,2019,65.04187513976083,34.95812486023917
1174,Still Alice,44779195,18754371,26024824,2015.csv,2015,41.88188510311541,58.118114896884585
1175,The Man from Nowhere,44723232,528175,44195057,2010.csv,2010,1.1809857570222115,98.81901424297779
1176,Mother!,44516999,17800004,26716995,2017.csv,2017,39.984734820062776,60.01526517993722
1177,Oculus,44446287,27695246,16751041,2014.csv,2014,62.31172021185931,37.68827978814068
1178,House at the End of the Street,44287131,31611916,12675215,2012.csv,2012,71.37946235442526,28.62053764557474
1179,Winchester,44019588,25091816,18927772,2018.csv,2018,57.00147852360635,42.99852147639365
1180,Kick,43996483,2472695,41523788,2014.csv,2014,5.6202105972879695,94.37978940271203
1181,Wind River,43980821,33800859,10179962,2017.csv,2017,76.85363354176586,23.146366458234148
1182,Max,43967255,42656255,1311000,2015.csv,2015,97.01823550276222,2.9817644972377737
1183,Battle of Memories,43892362,594552,43297810,2017.csv,2017,1.354568250393998,98.645431749606
1184,Of Gods and Men,43803417,3951596,39851821,2010.csv,2010,9.021204898238874,90.97879510176112
1185,Café Society,43763247,11103205,32660042,2016.csv,2016,25.371072215002695,74.6289277849973
1186,Richard Jewell,43745542,22345542,21400000,2019.csv,2019,51.080729551824966,48.91927044817504
1187,The DUFF,43709744,34030343,9679401,2015.csv,2015,77.85527867653491,22.144721323465085
1188,Judy,43660268,24313888,19346380,2019.csv,2019,55.68881986706998,44.31118013293001
1189,Boy,43551154,256211,43294943,2010.csv,2010,0.5882989920313019,99.4117010079687
1190,League of Gods,43498766,181633,43317133,2016.csv,2016,0.4175589716728976,99.58244102832711
1191,Harriet,43347017,43082155,264862,2019.csv,2019,99.38897294824231,0.6110270517576792
1192,Beastly,43202283,27865571,15336712,2011.csv,2011,64.50022791619601,35.499772083804
1193,The Snowman,43155261,6700035,36455226,2017.csv,2017,15.52541878961177,84.47458121038824
1194,Annihilation,43070915,32732301,10338614,2018.csv,2018,75.99629819798349,24.00370180201651
1195,When in Rome,43053376,32680633,10372743,2010.csv,2010,75.90724824924298,24.092751750757014
1196,Gifted,43046590,24801212,18245378,2017.csv,2017,57.614812230190594,42.385187769809406
1197,The Possession of Hannah Grace,43016528,14837422,28179106,2018.csv,2018,34.492374651901244,65.50762534809877
1198,Legend,42972994,1872994,41100000,2015.csv,2015,4.358537364187378,95.64146263581263
1199,The Gallows,42964410,22764410,20200000,2015.csv,2015,52.98434215668271,47.01565784331729
1200,Unhinged,42831465,20831465,22000000,2020.csv,2020,48.63589186127535,51.36410813872465
1201,Xin Shao Lin si,42741494,66099,42675395,2011.csv,2011,0.1546483143523247,99.84535168564767
1202,Almost Christmas,42580920,42158780,422140,2016.csv,2016,99.00861700498722,0.9913829950127897
1203,Love the Coopers,42426912,26302731,16124181,2015.csv,2015,61.99539339558816,38.00460660441184
1204,My Name Is Khan,42345360,4018771,38326589,2010.csv,2010,9.490463654105195,90.5095363458948
1205,Loving Vincent,42187665,6735118,35452547,2017.csv,2017,15.964661708582353,84.03533829141764
1206,Long Day's Journey Into Night,42140994,521365,41619629,2018.csv,2018,1.237191984602926,98.76280801539707
1207,Jobs,42128352,16131410,25996942,2013.csv,2013,38.29110144161348,61.70889855838653
1208,Going the Distance,42059111,17804299,24254812,2010.csv,2010,42.331610385202865,57.668389614797135
1209,Bang Bang,42045981,2546172,39499809,2014.csv,2014,6.055684608714445,93.94431539128556
1210,Mary and the Witch's Flower,41978431,2418404,39560027,2017.csv,2017,5.7610633422673665,94.23893665773264
1211,"As Above, So Below",41898409,21321100,20577309,2014.csv,2014,50.887612462802586,49.112387537197414
1212,Call Me by Your Name,41887595,18095701,23791894,2017.csv,2017,43.20062061333433,56.79937938666567
1213,The Guilt Trip,41863726,37134215,4729511,2012.csv,2012,88.70260377683535,11.297396223164656
1214,T2 Trainspotting,41681746,2402004,39279742,2017.csv,2017,5.762724047116452,94.23727595288355
1215,Overlord,41657844,21704844,19953000,2018.csv,2018,52.10265802522089,47.89734197477911
1216,Born to Be Wild,41644475,25978556,15665919,2011.csv,2011,62.38175892480336,37.61824107519665
1217,Safe,41564670,17142080,24422590,2012.csv,2012,41.24194899177595,58.75805100822406
1218,The Great Battle,41509280,472166,41037114,2018.csv,2018,1.13749503725432,98.86250496274567
1219,The Lady in the Van,41387687,10021175,31366512,2015.csv,2015,24.212938017048405,75.7870619829516
1220,Shark Night,41363927,18877153,22486774,2011.csv,2011,45.636752525938846,54.36324747406115
1221,Ricki and the Flash,41325328,26822144,14503184,2015.csv,2015,64.9048544756862,35.0951455243138
1222,This Is Where I Leave You,41296320,34296320,7000000,2014.csv,2014,83.04933708378857,16.95066291621142
1223,The Darkest Minds,41142379,12695691,28446688,2018.csv,2018,30.857940908084096,69.14205909191591
1224,50/50,41097853,35014192,6083661,2011.csv,2011,85.19713183070658,14.802868169293419
1225,Fist Fight,41087017,32187017,8900000,2017.csv,2017,78.33865622320549,21.661343776794503
1226,Dredd,41037742,13414714,27623028,2012.csv,2012,32.6887234682649,67.3112765317351
1227,Fright Night,41002607,18302607,22700000,2011.csv,2011,44.63766657568871,55.36233342431128
1228,Drive Angry,40909909,10721033,30188876,2011.csv,2011,26.2064454848824,73.79355451511759
1229,Underwater,40882928,17291078,23591850,2020.csv,2020,42.29412824834855,57.70587175165145
1230,Fighting with My Family,40811919,22958886,17853033,2019.csv,2019,56.25534540534593,43.74465459465407
1231,30 Minutes or Less,40662632,37053924,3608708,2011.csv,2011,91.12524737700205,8.87475262299794
1232,The Circle,40656399,20497844,20158555,2017.csv,2017,50.4172639588666,49.5827360411334
1233,The Roommate,40492652,37300000,3192652,2011.csv,2011,92.11547813662587,7.8845218633741245
1234,Holmes & Watson,40466970,30573626,9893344,2018.csv,2018,75.55205146320567,24.44794853679433
1235,The Witch,40423945,25138705,15285240,2016.csv,2016,62.18765882449128,37.81234117550872
1236,Carol,40272135,12711491,27560644,2015.csv,2015,31.56398586764769,68.43601413235231
1237,Diary of a Wimpy Kid: The Long Haul,40140972,20738724,19402248,2017.csv,2017,51.66472799911273,48.33527200088727
1238,The Wild Life,40075446,8005586,32069860,2016.csv,2016,19.976286726790267,80.02371327320974
1239,Northern Limit Line,40034677,337907,39696770,2015.csv,2015,0.8440357842777151,99.15596421572228
1240,Dream House,39984400,21302340,18682060,2011.csv,2011,53.276627884875104,46.7233721151249
1241,Brotherhood of Blades 2,39966092,14204,39951888,2017.csv,2017,0.035540127365968135,99.96445987263404
1242,Monte Carlo,39782683,23186769,16595914,2011.csv,2011,58.28357277964385,41.71642722035615
1243,The Forest,39712000,26594261,13117739,2016.csv,2016,66.96782080983078,33.03217919016922
1244,The November Man,39661919,25018119,14643800,2014.csv,2014,63.078438035234754,36.921561964765246
1245,Thugs of Hindostan,39570044,1449848,38120196,2018.csv,2018,3.6640040127324602,96.33599598726754
1246,Don Jon,39439355,24477704,14961651,2013.csv,2013,62.06415901071405,37.93584098928596
1247,Frank Miller's Sin City: A Dame to Kill For,39407616,13757804,25649812,2014.csv,2014,34.91153588179503,65.08846411820497
1248,Uri: The Surgical Strike,39346577,4186168,35160409,2019.csv,2019,10.639217739322024,89.36078226067798
1249,The Gambler,39280992,33680992,5600000,2014.csv,2014,85.74374089126874,14.256259108731268
1250,Mars Needs Moms,39233678,21392758,17840920,2011.csv,2011,54.526516733914164,45.473483266085836
1251,Absolutely Fabulous: The Movie,39219109,4772155,34446954,2016.csv,2016,12.167933238870878,87.83206676112913
1252,Samba,39178695,151530,39027165,2014.csv,2014,0.3867663279749364,99.61323367202506
1253,Show Dogs,39156854,17857020,21299834,2018.csv,2018,45.603816894993656,54.396183105006344
1254,Women Who Flirt,39156132,375495,38780637,2014.csv,2014,0.9589685722787942,99.04103142772121
1255,Believer,39047153,365639,38681514,2018.csv,2018,0.9364037372968012,99.0635962627032
1256,The Spy Gone North,38844509,500803,38343706,2018.csv,2018,1.2892504317663018,98.71074956823371
1257,Criminal,38803993,14708696,24095297,2015.csv,2015,37.90510940459143,62.09489059540857
1258,Train to Busan Presents: Peninsula,38700977,1231407,37469570,2020.csv,2020,3.1818499052362426,96.81815009476375
1259,On the Basis of Sex,38673750,24622687,14051063,2018.csv,2018,63.66769966708685,36.33230033291316
1260,"Crouching Tiger, Hidden Dragon: Sword of Destiny",38659039,0,38659039,2016.csv,2016,0.0,100.0
1261,The Best of Me,38609668,26766213,11843455,2014.csv,2014,69.32515710831805,30.674842891681948
1262,Million Dollar Arm,38483455,36457627,2025828,2014.csv,2014,94.73584687237671,5.2641531276232865
1263,Chernobyl Diaries,38390020,18119640,20270380,2012.csv,2012,47.19882927906784,52.801170720932156
1264,Boruto: Naruto The Movie,38362448,919651,37442797,2015.csv,2015,2.3972688082887723,97.60273119171123
1265,The Lazarus Effect,38356892,25801570,12555322,2015.csv,2015,67.26710287162996,32.73289712837005
1266,Don't Be Afraid of the Dark,38269529,24046682,14222847,2011.csv,2011,62.835061283351564,37.164938716648436
1267,The Water Diviner,38176317,4196641,33979676,2014.csv,2014,10.992786444014492,89.00721355598552
1268,Jumping the Broom,38158601,37295394,863207,2011.csv,2011,97.73784421499101,2.262155785008994
1269,Greenland,38100000,0,38100000,2020.csv,2020,0.0,100.0
1270,One for the Money,38080789,26414527,11666262,2011.csv,2011,69.36444252770077,30.635557472299226
1271,But Always,38039248,430760,37608488,2014.csv,2014,1.1324093473141215,98.86759065268588
1272,Overcomer,38026103,34746945,3279158,2019.csv,2019,91.37656046426845,8.623439535731547
1273,The Eagle,37989684,19490041,18499643,2011.csv,2011,51.30350913158425,48.69649086841575
1274,For Colored Girls,37981984,37729698,252286,2010.csv,2010,99.33577456090761,0.6642254390923865
1275,Killing Them Softly,37930465,15026056,22904409,2012.csv,2012,39.61474239770064,60.38525760229937
1276,Hell or High Water,37879877,27007844,10872033,2016.csv,2016,71.29865812394269,28.701341876057306
1277,The Handmaiden,37692886,2006788,35686098,2016.csv,2016,5.3240497424368085,94.67595025756319
1278,Pokémon the Movie: I Choose You!,37552144,2401722,35150422,2017.csv,2017,6.395698738266449,93.60430126173355
1279,A Walk in the Woods,37461274,29504281,7956993,2015.csv,2015,78.75941699153104,21.240583008468956
1280,Pain and Glory,37359689,4567338,32792351,2019.csv,2019,12.225310547954509,87.7746894520455
1281,Snowden,37357216,21587519,15769697,2016.csv,2016,57.786744601096615,42.213255398903385
1282,Home Again,37270721,27020284,10250437,2017.csv,2017,72.49734718037786,27.502652819622135
1283,"Like Father, Like Son",37170163,334616,36835547,2013.csv,2013,0.9002274216553745,99.09977257834463
1284,Till The End Of The World,37013733,118660,36895073,2018.csv,2018,0.3205837141582018,99.6794162858418
1285,2.0,36945969,4152000,32793969,2018.csv,2018,11.238032490093845,88.76196750990616
1286,Devil's Due,36921560,15821461,21100099,2014.csv,2014,42.8515506928743,57.1484493071257
1287,Ex Machina,36869414,25442958,11426456,2015.csv,2015,69.00830590906598,30.99169409093402
1288,The Adventurers,36796816,216556,36580260,2017.csv,2017,0.5885183109321197,99.41148168906788
1289,Burnt,36606743,13651946,22954797,2015.csv,2015,37.29352813496683,62.70647186503317
1290,The Intruder,36599361,35419122,1180239,2019.csv,2019,96.77524697767265,3.224753022327357
1291,The Priests,36577134,185093,36392041,2015.csv,2015,0.5060347265042691,99.49396527349573
1292,Furry Vengeance,36288132,17630465,18657667,2010.csv,2010,48.584658477322556,51.41534152267744
1293,A Most Wanted Man,36233517,17237855,18995662,2014.csv,2014,47.574335662751146,52.425664337248854
1294,A Very Harold & Kumar Christmas,36192775,35061031,1131744,2011.csv,2011,96.873011257081,3.126988742918994
1295,Nothing to Lose,36075317,1016188,35059129,2018.csv,2018,2.8168512005036574,97.18314879949634
1296,Kundo: Age of the Rampant,35941291,280958,35660333,2014.csv,2014,0.781713711953196,99.21828628804681
1297,Ra.One,35911689,2511689,33400000,2011.csv,2011,6.994070927713815,93.0059290722862
1298,You Will Meet a Tall Dark Stranger,35867322,3248246,32619076,2010.csv,2010,9.056282484652742,90.94371751534726
1299,Conquest 1453,35797045,35730,35761315,2012.csv,2012,0.09981270800425007,99.90018729199575
1300,Tad the Lost Explorer and the Secret of King Midas,35704046,5874,35698172,2017.csv,2017,0.016451916962016012,99.98354808303799
1301,Hostiles,35669017,29819114,5849903,2017.csv,2017,83.5994835517895,16.4005164482105
1302,Faster,35626958,23240020,12386938,2010.csv,2010,65.23155864163311,34.768441358366886
1303,Tyler Perry's Good Deeds,35579177,35025791,553386,2012.csv,2012,98.44463518647439,1.555364813525619
1304,Mia and the White Lion,35487190,399471,35087719,2018.csv,2018,1.1256766173934876,98.8743233826065
1305,Arbitrage,35485056,7919574,27565482,2012.csv,2012,22.318054112694654,77.68194588730535
1306,Room,35401758,14677654,20724104,2015.csv,2015,41.46024047732319,58.53975952267682
1307,Namiya,35351623,70814,35280809,2017.csv,2017,0.20031329254670996,99.79968670745329
1308,Eye in the Sky,35259653,18704595,16555058,2016.csv,2016,53.04815393390287,46.95184606609713
1309,Courageous,35185884,34522221,663663,2011.csv,2011,98.1138373559124,1.886162644087612
1310,The Girl in the Spider's Web,35164920,14841338,20323582,2018.csv,2018,42.204953118050604,57.795046881949396
1311,My Week with Marilyn,35057696,14600347,20457349,2011.csv,2011,41.64662446727817,58.35337553272183
1312,When Marnie Was There,34949567,561085,34388482,2014.csv,2014,1.6054133088401354,98.39458669115987
1313,The Sitter,34942188,30441326,4500862,2011.csv,2011,87.11911801287316,12.880881987126852
1314,The Hate U Give,34934009,29719483,5214526,2018.csv,2018,85.07321046376326,14.926789536236736
1315,Lost and Love,34930177,188817,34741360,2015.csv,2015,0.5405555202311171,99.45944447976889
1316,Secret in Their Eyes,34854990,20180155,14674835,2015.csv,2015,57.8974631752871,42.10253682471291
1317,Chimpanzee,34823764,28972764,5851000,2012.csv,2012,83.19825507661952,16.801744923380483
1318,Kidnap,34814102,30971040,3843062,2017.csv,2017,88.96119164584513,11.038808354154876
1319,Broken City,34737199,19701164,15036035,2013.csv,2013,56.714889418689175,43.28511058131083
1320,Endless Love,34718173,23438250,11279923,2014.csv,2014,67.51003285800782,32.489967141992175
1321,Jane Eyre,34710627,11242660,23467967,2011.csv,2011,32.38967708650149,67.6103229134985
1322,The Kids Are All Right,34705850,20811365,13894485,2010.csv,2010,59.96500589958177,40.03499410041823
1323,The Man Standing Next,34664900,113527,34551373,2020.csv,2020,0.32749842059258794,99.67250157940741
1324,Alex Cross,34618867,25888412,8730455,2012.csv,2012,74.78122262060165,25.21877737939835
1325,Trolls World Tour,34572374,0,34572374,2020.csv,2020,0.0,100.0
1326,Salmon Fishing in the Yemen,34564651,9047981,25516670,2012.csv,2012,26.17697774526929,73.8230222547307
1327,Haywire,34513760,18942396,15571364,2012.csv,2012,54.883605843002904,45.11639415699709
1328,Steve Jobs,34441873,17766658,16675215,2015.csv,2015,51.584471030364696,48.415528969635304
1329,Victor Frankenstein,34227298,5775076,28452222,2015.csv,2015,16.872719546836564,83.12728045316344
1330,The House,34184504,25584504,8600000,2017.csv,2017,74.8424022767743,25.157597723225706
1331,Cirque du Soleil: Worlds Away,34153101,12512862,21640239,2012.csv,2012,36.6375574504933,63.3624425495067
1332,The Bad Guys: The Movie,34024386,166972,33857414,2019.csv,2019,0.49074214006389416,99.50925785993611
1333,The Witness,33963557,418063,33545494,2015.csv,2015,1.2309164202088727,98.76908357979113
1334,The Good Liar,33856058,17156058,16700000,2019.csv,2019,50.67352495674482,49.326475043255186
1335,The Art of Racing in the Rain,33766787,26395642,7371145,2019.csv,2019,78.17042823766442,21.829571762335576
1336,I Want to Eat Your Pancreas,33748006,277019,33470987,2017.csv,2017,0.8208455338072419,99.17915446619276
1337,Nobody's Fool,33705333,31713110,1992223,2018.csv,2018,94.08929441521909,5.910705584780901
1338,The Skin I Live In,33678406,3185812,30492594,2011.csv,2011,9.459509455405936,90.54049054459406
1339,Bloodshot,33482340,12561824,20920516,2020.csv,2020,37.51776010876181,62.48223989123819
1340,2016: Obama's America,33449086,33449086,0,2012.csv,2012,100.0,0.0
1341,Get on Up,33448971,30703100,2745871,2014.csv,2014,91.79086555457864,8.209134445421356
1342,The Perks of Being a Wallflower,33384127,17742948,15641179,2012.csv,2012,53.14785676438386,46.85214323561613
1343,Perfect Strangers,33262366,1014507,32247859,2017.csv,2017,3.050014541960124,96.94998545803988
1344,Project Almanac,33213241,22348241,10865000,2015.csv,2015,67.28714310054836,32.71285689945164
1345,Bharat,33185983,2971549,30214434,2019.csv,2019,8.954229259986061,91.04577074001395
1346,Baaghi 2,33139063,1319579,31819484,2018.csv,2018,3.9819442088631174,96.01805579113687
1347,Lockout,32948113,14326864,18621249,2012.csv,2012,43.483109336185656,56.516890663814344
1348,Inside Llewyn Davis,32935319,13235319,19700000,2013.csv,2013,40.185792644060925,59.814207355939075
1349,Sleepless,32917353,20783704,12133649,2017.csv,2017,63.13905009312262,36.86094990687738
1350,Brightburn,32893421,17300439,15592982,2019.csv,2019,52.59543846169117,47.40456153830883
1351,Katy Perry: Part of Me,32726956,25326071,7400885,2012.csv,2012,77.38596586862523,22.614034131374762
1352,Leap Year,32686500,25918920,6767580,2010.csv,2010,79.29548896333348,20.704511036666513
1353,Mud,32613173,21590086,11023087,2013.csv,2013,66.20050738393348,33.799492616066516
1354,The Hurricane Heist,32517248,6115825,26401423,2018.csv,2018,18.80794155766195,81.19205844233804
1355,UglyDolls,32450241,20150241,12300000,2019.csv,2019,62.09581309426947,37.90418690573053
1356,Movie 43,32438988,8840453,23598535,2012.csv,2012,27.25255485775327,72.74744514224673
1357,Stuber,32390945,22370452,10020493,2019.csv,2019,69.06390659488324,30.93609340511677
1358,Kevin Hart: Let Me Explain,32318051,32244051,74000,2013.csv,2013,99.7710257960791,0.2289742039208986
1359,Potiche,32309881,1618844,30691037,2010.csv,2010,5.0103681904616115,94.9896318095384
1360,Seven Psychopaths,32226382,15024049,17202333,2012.csv,2012,46.62034044032619,53.37965955967381
1361,The Kid Who Would Be King,32140970,16790790,15350180,2019.csv,2019,52.24108046521309,47.75891953478691
1362,You Again,32054369,25702053,6352316,2010.csv,2010,80.18268274131367,19.81731725868633
1363,Dilwale,31994323,4871263,27123060,2015.csv,2015,15.225397955756087,84.7746020442439
1364,Suffragette,31972096,4702420,27269676,2015.csv,2015,14.70788777814254,85.29211222185747
1365,Bad Times at the El Royale,31882724,17839115,14043609,2018.csv,2018,55.952292533097236,44.047707466902764
1366,Self/less,31807156,12279691,19527465,2015.csv,2015,38.60669278322148,61.39330721677852
1367,Spring Breakers,31724284,14124284,17600000,2013.csv,2013,44.52199457046848,55.47800542953152
1368,Hunter Killer,31672678,15767460,15905218,2018.csv,2018,49.782528651350546,50.217471348649454
1369,New World,31670607,457806,31212801,2013.csv,2013,1.445523289149463,98.55447671085054
1370,Ae Dil Hai Mushkil,31668920,4264983,27403937,2016.csv,2016,13.46740905594507,86.53259094405493
1371,Anna,31626978,7743794,23883184,2019.csv,2019,24.48477372703772,75.51522627296228
1372,Super Troopers 2,31626386,30617396,1008990,2018.csv,2018,96.80965760678441,3.1903423932155888
1373,Bodyguard,31516209,1834384,29681825,2011.csv,2011,5.820446234507457,94.17955376549254
1374,The Thing,31505287,16928670,14576617,2011.csv,2011,53.732790943945375,46.267209056054625
1375,I Don't Know How She Does It,31410151,9662284,21747867,2011.csv,2011,30.76166045811114,69.23833954188886
1376,What's in a Name?,31303580,8111,31295469,2012.csv,2012,0.025910774422605976,99.97408922557739
1377,Tazza: The Hidden Card,31278476,251555,31026921,2014.csv,2014,0.8042431479078457,99.19575685209216
1378,Saving Mr. Wu,31222161,92696,31129465,2015.csv,2015,0.29689168536412325,99.70310831463588
1379,My Dear Liar,31177968,90545,31087423,2019.csv,2019,0.29041340987969455,99.7095865901203
1380,Joyful Noise,31158113,30932113,226000,2012.csv,2012,99.27466724316713,0.7253327568328672
1381,Premium Rush,31083599,20275446,10808153,2012.csv,2012,65.22875938529512,34.77124061470488
1382,The Wild Goose Lake,31042413,12573,31029840,2019.csv,2019,0.040502650357754084,99.95949734964225
1383,The Strangers: Prey at Night,31039126,24586708,6452418,2018.csv,2018,79.21198554366512,20.788014456334885
1384,This Is Not What I Expected,30996615,337670,30658945,2017.csv,2017,1.0893770174581965,98.91062298254181
1385,Playing for Keeps,30962335,13103272,17859063,2012.csv,2012,42.32003820125323,57.679961798746774
1386,Billy Lynn's Long Halftime Walk,30930984,1738477,29192507,2016.csv,2016,5.620503376161587,94.3794966238384
1387,African Cats,30857747,15428747,15429000,2011.csv,2011,49.9995900543225,50.000409945677504
1388,Attack on Titan Part 1,30810658,449523,30361135,2015.csv,2015,1.4589853939503663,98.54101460604964
1389,Winter's Tale,30800231,12600231,18200000,2014.csv,2014,40.90953408758525,59.09046591241475
1390,Norm of the North,30734502,17062499,13672003,2016.csv,2016,55.51578157993254,44.48421842006746
1391,Carnage,30722632,2547047,28175585,2011.csv,2011,8.290458317503527,91.70954168249648
1392,A Man Called Ove,30691696,3479315,27212381,2015.csv,2015,11.336339966354418,88.66366003364558
1393,A Wedding Invitation,30665036,14350,30650686,2013.csv,2013,0.04679596658552757,99.95320403341448
1394,When the Bough Breaks,30658387,29747603,910784,2016.csv,2016,97.02925010373181,2.970749896268189
1395,Wild Tales,30642704,3106530,27536174,2014.csv,2014,10.137910805782676,89.86208919421732
1396,A Dangerous Method,30519436,5704709,24814727,2011.csv,2011,18.69205250057701,81.307947499423
1397,What's Your Number?,30426096,14011084,16415012,2011.csv,2011,46.04956219161341,53.95043780838659
1398,Nocturnal Animals,30311857,10663357,19648500,2016.csv,2016,35.17883117487655,64.82116882512345
1399,Far from the Madding Crowd,30229977,12236500,17993477,2015.csv,2015,40.4780327818311,59.5219672181689
1400,A Silent Voice: The Movie,30156463,310407,29846056,2016.csv,2016,1.0293216415996798,98.97067835840032
1401,When the Game Stands Tall,30138754,30127963,10791,2014.csv,2014,99.96419560012335,0.03580439987665051
1402,The Rum Diary,30134958,13109815,17025143,2011.csv,2011,43.50367768888213,56.49632231111787
1403,Reset 2017 Re-release,29949252,108970,29840282,2017.csv,2017,0.36384881999724067,99.63615118000277
1404,Keeping Up with the Joneses,29918745,14904426,15014319,2016.csv,2016,49.816347577413424,50.183652422586576
1405,The Bye Bye Man,29874280,22395806,7478474,2017.csv,2017,74.96684773658143,25.033152263418568
1406,Draft Day,29824199,28842237,981962,2014.csv,2014,96.70749916871195,3.2925008312880424
1407,The Disaster Artist,29820616,21120616,8700000,2017.csv,2017,70.82555236283517,29.174447637164842
1408,Like a Boss,29753143,22169514,7583629,2020.csv,2020,74.51150286878936,25.488497131210643
1409,The Swindlers,29721916,241916,29480000,2017.csv,2017,0.8139313764294335,99.18606862357056
1410,The Raven,29699345,16008272,13691073,2012.csv,2012,53.901094451746324,46.09890554825367
1411,Masterminds,29674699,17368022,12306677,2016.csv,2016,58.52804774868988,41.471952251310114
1412,Amour,29652180,6739492,22912688,2012.csv,2012,22.72848741643953,77.27151258356047
1413,Politics,29459596,1514558,27945038,2010.csv,2010,5.141136355026728,94.85886364497327
1414,The Losers,29397654,23591432,5806222,2010.csv,2010,80.24936955853688,19.75063044146312
1415,Mr. Holmes,29355203,17737646,11617557,2015.csv,2015,60.42419805443008,39.57580194556992
1416,Rowdy Rathore,29342463,777373,28565090,2012.csv,2012,2.649310659435781,97.35068934056422
1417,Sword Art Online The Movie: Ordinal Scale,29322339,1522976,27799363,2017.csv,2017,5.193910349375607,94.80608965062439
1418,Free Solo,29318861,17541090,11777771,2018.csv,2018,59.82868843370143,40.17131156629857
1419,Big Eyes,29253166,14482031,14771135,2014.csv,2014,49.5058586137309,50.4941413862691
1420,My Hero Academia: Heroes Rising,29187012,13304000,15883012,2019.csv,2019,45.58191842316713,54.418081576832876
1421,Special ID,29139936,12666,29127270,2013.csv,2013,0.04346612154535961,99.95653387845465
1422,Sacrifice,29093560,29792,29063768,2010.csv,2010,0.10240066873906115,99.89759933126093
1423,Pad Man,29045020,1670192,27374828,2018.csv,2018,5.750355826919726,94.24964417308027
1424,M.S. Dhoni: The Untold Story,28903047,1801550,27101497,2016.csv,2016,6.233079854867897,93.7669201451321
1425,Speak Bachchan,28775262,1216258,27559004,2012.csv,2012,4.226748656536993,95.773251343463
1426,Mirai,28756961,812794,27944167,2018.csv,2018,2.826425226226095,97.17357477377391
1427,Twins 2,28733523,1431255,27302268,2017.csv,2017,4.981133013170713,95.01886698682928
1428,The Suspect,28674130,218693,28455437,2013.csv,2013,0.7626839942484741,99.23731600575152
1429,The Fortress,28645448,252895,28392553,2017.csv,2017,0.8828453302598025,99.11715466974019
1430,Love & Mercy,28641776,12551031,16090745,2015.csv,2015,43.820714888629816,56.17928511137019
1431,I Give It a Year,28328531,34657,28293874,2013.csv,2013,0.12233955936507969,99.87766044063491
1432,The Master,28258060,16377274,11880786,2012.csv,2012,57.956115883397516,42.043884116602484
1433,Fan,28240000,2300000,25940000,2016.csv,2016,8.144475920679886,91.85552407932012
1434,Gully Boy,28141995,5566534,22575461,2019.csv,2019,19.780168392468266,80.21983160753173
1435,Your Highness,28013733,21596445,6417288,2011.csv,2011,77.09234967007075,22.907650329929254
1436,Mandela: Long Walk to Freedom,27985788,8323085,19662703,2013.csv,2013,29.740398948208995,70.259601051791
1437,The Brothers Grimsby,27979040,6874837,21104203,2016.csv,2016,24.571382720779557,75.42861727922045
1438,The 33,27972023,12227722,15744301,2015.csv,2015,43.71411392018375,56.28588607981625
1439,The Divine Move,27926871,136707,27790164,2014.csv,2014,0.48951778378608907,99.51048221621392
1440,Monster Family,27890108,127259,27762849,2017.csv,2017,0.4562872255639885,99.54371277443602
1441,The Beguiled,27869129,10709995,17159134,2017.csv,2017,38.42960072415611,61.57039927584389
1442,Dark Skies,27858103,17418667,10439436,2013.csv,2013,62.526393128778366,37.473606871221634
1443,Default,27694043,203775,27490268,2018.csv,2018,0.7358080580722721,99.26419194192772
1444,Nebraska,27682872,17654912,10027960,2013.csv,2013,63.77557935462765,36.22442064537235
1445,One Cut of the Dead,27590180,52406,27537774,2018.csv,2018,0.18994439325876092,99.81005560674124
1446,The Women on the 6th Floor,27533970,719823,26814147,2011.csv,2011,2.6143087974600103,97.38569120253999
1447,The Happytime Murders,27506452,20706452,6800000,2018.csv,2018,75.27852737968533,24.72147262031468
1448,The Incredible Burt Wonderstone,27437881,22537881,4900000,2013.csv,2013,82.14147805364416,17.858521946355843
1449,Left Behind,27405896,14019924,13385972,2014.csv,2014,51.15659783573578,48.84340216426422
1450,Irrational Man,27391084,4030360,23360724,2015.csv,2015,14.714131065422603,85.28586893457741
1451,Jing wu feng yun: Chen Zhen,27390678,50433,27340245,2010.csv,2010,0.18412468650830768,99.8158753134917
1452,Detective K: Secret of the Lost Island,27387870,185367,27202503,2015.csv,2015,0.6768215271943382,99.32317847280567
1453,Midnight Sun,27365467,9561064,17804403,2018.csv,2018,34.93842805606058,65.06157194393943
1454,Ramona and Beezus,27293743,26167002,1126741,2010.csv,2010,95.87179742990912,4.128202570090881
1455,American Ultra,27262374,14440985,12821389,2015.csv,2015,52.970386951627916,47.029613048372084
1456,Khumba,27187375,1029,27186346,2013.csv,2013,0.0037848449877930478,99.99621515501221
1457,Splice 2010 Re-release,27127620,17010170,10117450,2010.csv,2010,62.7042475528631,37.295752447136906
1458,Let Me In,27093592,12134935,14958657,2010.csv,2010,44.78894861928976,55.21105138071024
1459,My Neighbor Totoro 2018 Re-release,27083857,1144649,25939208,2018.csv,2018,4.2263145902742,95.7736854097258
1460,Hitchcock,27039669,6008677,21030992,2012.csv,2012,22.221710628188532,77.77828937181147
1461,Total Dhamaal,26911995,2167632,24744363,2019.csv,2019,8.05451992689505,91.94548007310495
1462,You're Next,26895481,18494006,8401475,2013.csv,2013,68.76250326216513,31.23749673783488
1463,Chips,26800152,18600152,8200000,2017.csv,2017,69.40315860895117,30.59684139104883
1464,A Cure for Wellness,26620002,8106986,18513016,2017.csv,2017,30.45449057441844,69.54550942558157
1465,Missing Link,26565710,16649539,9916171,2019.csv,2019,62.67304355878311,37.32695644121689
1466,No Manches Frida 2,26493648,9270920,17222728,2019.csv,2019,34.99299152762957,65.00700847237043
1467,A Hard Day,26488847,19004,26469843,2014.csv,2014,0.07174340204388661,99.9282565979561
1468,The Way Way Back,26474920,21506546,4968374,2013.csv,2013,81.23365811870254,18.766341881297468
1469,Only the Brave,26351322,18343983,8007339,2017.csv,2017,69.61314123063731,30.38685876936269
1470,Twenty Two,26289378,46796,26242582,2017.csv,2017,0.17800345067121784,99.82199654932879
1471,Aloha,26250020,21067116,5182904,2015.csv,2015,80.25561885286182,19.744381147138174
1472,Apollo 18,26236153,17687709,8548444,2011.csv,2011,67.41731152429246,32.58268847570755
1473,The Zookeeper's Wife,26152835,17571660,8581175,2017.csv,2017,67.18835644395722,32.811643556042775
1474,Badrinath Ki Dulhania,26134309,1993259,24141050,2017.csv,2017,7.6269818344919695,92.37301816550803
1475,Top Five,26117471,25317471,800000,2014.csv,2014,96.93691628871723,3.0630837112827654
1476,Hichki,26055222,330279,25724943,2018.csv,2018,1.2676115367583511,98.73238846324165
1477,Iceman,26033917,7679,26026238,2014.csv,2014,0.02949613767302093,99.97050386232698
1478,Agneepath,26001696,1986748,24014948,2012.csv,2012,7.640840043664844,92.35915995633516
1479,The Light Between Oceans,25975621,12545979,13429642,2016.csv,2016,48.299053177592945,51.700946822407055
1480,White Boy Rick,25957482,24011188,1946294,2018.csv,2018,92.5019922964793,7.498007703520704
1481,"Paul, Apostle of Christ",25915966,17560475,8355491,2018.csv,2018,67.75929170458087,32.240708295419125
1482,Huevos: Little Rooster's Egg-cellent Adventure,25892561,9080818,16811743,2015.csv,2015,35.07114649647827,64.92885350352172
1483,Rust and Bone,25807712,2062027,23745685,2012.csv,2012,7.989964395138942,92.01003560486106
1484,Our Idiot Brother,25804448,24816118,988330,2011.csv,2011,96.16992388289026,3.8300761171097326
1485,Fair Game,25798915,9540691,16258224,2010.csv,2010,36.98097768840279,63.01902231159722
1486,Leap,25780959,83074,25697885,2020.csv,2020,0.3222300613410075,99.67776993865898
1487,"The Gangster, the Cop, the Devil",25775371,216494,25558877,2019.csv,2019,0.8399258346271717,99.16007416537282
1488,A Beautiful Planet,25730120,15650615,10079505,2016.csv,2016,60.82604744944835,39.17395255055165
1489,Fireworks,25672406,525280,25147126,2017.csv,2017,2.0460879280266915,97.9539120719733
1490,Emma.,25645655,10055355,15590300,2020.csv,2020,39.20880554620266,60.79119445379734
1491,Father Figures,25601244,17501244,8100000,2017.csv,2017,68.36091246191005,31.639087538089942
1492,"Love, Rosie",25574387,20431,25553956,2014.csv,2014,0.07988852284123173,99.92011147715877
1493,Mr. Donkey,25537759,356255,25181504,2016.csv,2016,1.3950127730471573,98.60498722695284
1494,Keys To The Heart,25375866,75134,25300732,2018.csv,2018,0.29608447648643793,99.70391552351356
1495,A Haunted House 2,25358716,17329486,8029230,2014.csv,2014,68.33739531607199,31.662604683928002
1496,And So It Goes,25312387,15160801,10151586,2014.csv,2014,59.89478985130877,40.105210148691235
1497,Enough Said,25288872,17550872,7738000,2013.csv,2013,69.40156128751018,30.598438712489827
1498,Biutiful,25147786,5101237,20046549,2010.csv,2010,20.285034237208794,79.7149657627912
1499,On the Other Side of the Tracks,25109572,9572,25100000,2012.csv,2012,0.03812092057961004,99.96187907942038
1500,Born in China,25081168,13873211,11207957,2016.csv,2016,55.31325734112542,44.68674265887458
1501,Race,25070261,19206207,5864054,2016.csv,2016,76.60952153629353,23.39047846370646
1502,The Last Exorcism 2,25051865,15179302,9872563,2013.csv,2013,60.591504864009124,39.408495135990876
1503,Free State of Jones,25035950,20810036,4225914,2016.csv,2016,83.12061655339622,16.879383446603786
1504,Whiskey Tango Foxtrot,24972139,23083334,1888805,2016.csv,2016,92.4363507667485,7.563649233251504
1505,Housefull 2,24922847,1791780,23131067,2012.csv,2012,7.189307064317331,92.81069293568267
1506,Booksmart,24863452,22680962,2182490,2019.csv,2019,91.22209578943423,8.777904210565774
1507,Wild City,24817852,34866,24782986,2015.csv,2015,0.14048758127818636,99.85951241872182
1508,Elle s'appelait Sarah,24792815,7693187,17099628,2010.csv,2010,31.029905236658283,68.97009476334172
1509,Lottery Ticket,24719879,24719879,0,2010.csv,2010,100.0,0.0
1510,Big Miracle,24719215,20157300,4561915,2012.csv,2012,81.5450652458017,18.4549347541983
1511,Super 30,24701637,2269878,22431759,2019.csv,2019,9.189180457959123,90.81081954204087
1512,Scoob!,24700000,0,24700000,2020.csv,2020,0.0,100.0
1513,Drug War,24676341,128195,24548146,2013.csv,2013,0.5195057079167451,99.48049429208325
1514,Ready,24663361,955148,23708213,2011.csv,2011,3.872740621199195,96.1272593788008
1515,The Death of Stalin,24646055,8047856,16598199,2017.csv,2017,32.65372896392547,67.34627103607454
1516,The Snow Queen 3: Fire and Ice,24644317,0,24644317,2016.csv,2016,0.0,100.0
1517,Sparkle,24637800,24397469,240331,2012.csv,2012,99.02454358749564,0.9754564125043632
1518,The Players,24629152,10854,24618298,2012.csv,2012,0.044069726801799755,99.9559302731982
1519,Honest Thief,24626787,12558569,12068218,2020.csv,2020,50.995564301587535,49.004435698412465
1520,Capture the Flag,24604331,6690,24597641,2015.csv,2015,0.027190334904858827,99.97280966509514
1521,God's Not Dead 2,24487848,20774575,3713273,2016.csv,2016,84.83626245964938,15.163737540350628
1522,Stan & Ollie,24420923,5470235,18950688,2018.csv,2018,22.399788083357866,77.60021191664214
1523,The Tale of The Princess Kaguya,24366656,703232,23663424,2013.csv,2013,2.8860423030554543,97.11395769694454
1524,The Great Beauty,24271739,2852400,21419339,2013.csv,2013,11.751939158541544,88.24806084145845
1525,Jackie,24262468,13960394,10302074,2016.csv,2016,57.53905167438036,42.46094832561963
1526,Trance,24261569,2328743,21932826,2013.csv,2013,9.598484747626998,90.401515252373
1527,The Accidental Detective 2: In Action,24243825,179045,24064780,2018.csv,2018,0.7385179525095565,99.26148204749045
1528,Jolly LLB 2,24214186,1654254,22559932,2017.csv,2017,6.831755566757438,93.16824443324256
1529,The Gunman,24177137,10664749,13512388,2015.csv,2015,44.110884593159234,55.88911540684077
1530,The Railway Man,24174885,4438438,19736447,2013.csv,2013,18.359706778336278,81.64029322166371
1531,The Way Back,24172201,2701859,21470342,2010.csv,2010,11.177546471668013,88.82245352833199
1532,The Founder,24121245,12786053,11335192,2016.csv,2016,53.00743390318369,46.99256609681631
1533,Bad Santa 2,24079268,17782178,6297090,2016.csv,2016,73.84849904905747,26.15150095094253
1534,Kung Fu Jungle,24070765,129784,23940981,2014.csv,2014,0.5391768811668428,99.46082311883315
1535,I Can Speak,24024444,63239,23961205,2017.csv,2017,0.2632277358843351,99.73677226411567
1536,Spirits' Homecoming,23857217,125616,23731601,2016.csv,2016,0.5265324953870353,99.47346750461297
1537,Silence,23834809,7100177,16734632,2016.csv,2016,29.78910802264033,70.21089197735967
1538,Wanderlust,23812816,17450535,6362281,2012.csv,2012,73.28211413551425,26.717885864485748
1539,The Dressmaker,23762417,2022115,21740302,2015.csv,2015,8.509719360618913,91.49028063938108
1540,Pokémon the Movie: The Power of Us,23740788,789170,22951618,2018.csv,2018,3.3241103875743296,96.67588961242566
1541,The Peanut Butter Falcon,23725674,20457151,3268523,2019.csv,2019,86.22368747037493,13.776312529625082
1542,Amy,23706049,8413144,15292905,2015.csv,2015,35.48943984718837,64.51056015281164
1543,To the Arctic 3D,23695388,14560838,9134550,2012.csv,2012,61.450093157368855,38.549906842631145
1544,What Now?,23591043,23591043,0,2016.csv,2016,100.0,0.0
1545,The War with Grandpa,23576325,15449198,8127127,2020.csv,2020,65.52844007706884,34.471559922931164
1546,No manches Frida,23540937,11528613,12012324,2016.csv,2016,48.972617360133114,51.02738263986688
1547,Youth,23469540,2703296,20766244,2015.csv,2015,11.518316933352763,88.48168306664724
1548,Wish Upon,23468586,14301505,9167081,2017.csv,2017,60.938929171105585,39.06107082889442
1549,Only Cloud Knows,23410836,0,23410836,2019.csv,2019,0.0,100.0
1550,Detroit,23355100,16790139,6564961,2017.csv,2017,71.89067484189748,28.10932515810251
1551,Middle School: The Worst Years of My Life,23316139,20007149,3308990,2016.csv,2016,85.80815631610362,14.191843683896376
1552,Warrior,23308615,13657115,9651500,2011.csv,2011,58.592563307601075,41.407436692398925
1553,Triple 9,23177948,12639297,10538651,2016.csv,2016,54.53156163781194,45.46843836218806
1554,Hoodwinked Too! Hood vs. Evil,23167844,10143779,13024065,2011.csv,2011,43.78387130023838,56.21612869976161
1555,Rock Dog,23157646,9420546,13737100,2016.csv,2016,40.68006739545116,59.31993260454884
1556,Dark Waters,23108017,11136084,11971933,2019.csv,2019,48.19143070562914,51.80856929437086
1557,The Choice,23064015,18730891,4333124,2016.csv,2016,81.21262061267304,18.78737938732697
1558,Padmaavat,22991060,11846060,11145000,2018.csv,2018,51.524636097683185,48.475363902316815
1559,Young Adult,22939027,16311571,6627456,2011.csv,2011,71.10838223434673,28.891617765653265
1560,A Separation,22926076,7099055,15827021,2011.csv,2011,30.964980662194435,69.03501933780556
1561,Baggage Claim,22871096,21569509,1301587,2013.csv,2013,94.30903092707057,5.69096907292943
1562,Won't You Be My Neighbor?,22844741,22835787,8954,2018.csv,2018,99.96080498351897,0.03919501648103605
1563,Kon-Tiki,22842887,1517410,21325477,2012.csv,2012,6.642811830220935,93.35718816977906
1564,Hunt for the Wilderpeople,22835917,5205468,17630449,2016.csv,2016,22.795090733601807,77.20490926639819
1565,Sweet Sixteen,22819702,34327,22785375,2016.csv,2016,0.1504270301163442,99.84957296988367
1566,Captain Fantastic,22787526,5879835,16907691,2016.csv,2016,25.80286688427695,74.19713311572305
1567,Extraordinary Mission,22757764,54174,22703590,2017.csv,2017,0.23804623336457836,99.76195376663543
1568,Black and Blue,22741061,22055313,685748,2019.csv,2019,96.98453823240702,3.01546176759299
1569,Fading Gigolo,22706304,3769873,18936431,2014.csv,2014,16.60275930420028,83.39724069579972
1570,Live by Night,22678555,10378555,12300000,2016.csv,2016,45.76374023830002,54.23625976169999
1571,The Farewell,22671661,17695781,4975880,2019.csv,2019,78.0524241254313,21.947575874568695
1572,Julieta,22468044,1490948,20977096,2016.csv,2016,6.635860246668557,93.36413975333144
1573,Late Night,22386555,15499454,6887101,2019.csv,2019,69.23554785450463,30.764452145495362
1574,2 States,22386518,2238174,20148344,2014.csv,2014,9.997865679691678,90.00213432030833
1575,Mojin: The Worm Valley,22381583,101516,22280067,2018.csv,2018,0.4535693476194244,99.54643065238058
1576,Solace,22354572,0,22354572,2015.csv,2015,0.0,100.0
1577,Twenty,22271862,136125,22135737,2015.csv,2015,0.6111972137758397,99.38880278622416
1578,Fei chang xing yun,22259179,64432,22194747,2013.csv,2013,0.28946260776284694,99.71053739223716
1579,Fifty Shades of Black,22227514,11686940,10540574,2015.csv,2015,52.578709431922974,47.421290568077026
1580,Upside Down,22187813,105095,22082718,2012.csv,2012,0.4736609236791386,99.52633907632085
1581,Mr. Turner,22179785,3958500,18221285,2014.csv,2014,17.847332604892248,82.15266739510774
1582,Sabotage,22126842,10508518,11618324,2014.csv,2014,47.49217262906293,52.50782737093708
1583,The Glass Castle,22088533,17273059,4815474,2017.csv,2017,78.19921313923382,21.800786860766173
1584,Gretel & Hansel,22051055,15347654,6703401,2020.csv,2020,69.60054292186926,30.39945707813073
1585,A Thousand Words,22044277,18450127,3594150,2010.csv,2010,83.69576829396583,16.304231706034177
1586,Big Brother,22029250,85624,21943626,2018.csv,2018,0.3886832279809798,99.61131677201902
1587,Bullet to the Head,21947209,9489829,12457380,2013.csv,2013,43.23934309824999,56.76065690175002
1588,Leap! 2017 Re-release,21929861,21858070,71791,2017.csv,2017,99.67263358395203,0.32736641604796307
1589,Black or White,21833967,21571189,262778,2015.csv,2015,98.79647157110753,1.2035284288924684
1590,Master Z: The Ip Man Legacy,21832649,209454,21623195,2018.csv,2018,0.9593613674639299,99.04063863253607
1591,Welcome Back,21775694,1388365,20387329,2015.csv,2015,6.37575546386719,93.6242445361328
1592,Diana,21766271,335359,21430912,2013.csv,2013,1.5407278536594533,98.45927214634055
1593,Legends of Oz: Dorothy's Return,21755418,8462347,13293071,2014.csv,2014,38.897652989246176,61.10234701075383
1594,Proud Mary,21753365,20877013,876352,2018.csv,2018,95.97141867476596,4.02858132523405
1595,It Follows,21729511,14674076,7055435,2015.csv,2015,67.53063149925464,32.46936850074537
1596,22 Bullets,21695883,0,21695883,2010.csv,2010,0.0,100.0
1597,Just Wright,21584424,21540363,44061,2010.csv,2010,99.79586668608808,0.20413331391192094
1598,The Star 2019 Re-release,21502695,43510,21459185,2019.csv,2019,0.2023467290960505,99.79765327090395
1599,My Soul to Take,21500813,14744435,6756378,2010.csv,2010,68.57617430559486,31.42382569440514
1600,Our Family Wedding,21409028,20255281,1153747,2010.csv,2010,94.61093235993712,5.3890676400628745
1601,Love & Friendship,21401949,14016568,7385381,2016.csv,2016,65.49201663829776,34.507983361702244
1602,Shaft,21360215,21360215,0,2019.csv,2019,100.0,0.0
1603,Bears,21316745,17780194,3536551,2014.csv,2014,83.40951679067324,16.590483209326752
1604,Hotel Mumbai,21314816,9651611,11663205,2019.csv,2019,45.28123067072219,54.71876932927782
1605,Love Live! The School Idol Movie,21292009,115840,21176169,2015.csv,2015,0.5440538748598125,99.45594612514019
1606,I'm So Excited!,21245677,1368119,19877558,2013.csv,2013,6.439517083875463,93.56048291612453
1607,Unplanned,21238296,19005109,2233187,2019.csv,2019,89.48509334270508,10.514906657294917
1608,The Prison,21205329,207481,20997848,2017.csv,2017,0.9784380143312088,99.0215619856688
1609,The Prodigy,21150265,14856291,6293974,2018.csv,2018,70.24163054221779,29.75836945778221
1610,Beasts of the Southern Wild,21107746,12795746,8312000,2012.csv,2012,60.62109142302546,39.37890857697454
1611,Gonjiam: Haunted Asylum,21041950,115252,20926698,2018.csv,2018,0.5477249019221128,99.45227509807789
1612,Yves Saint Laurent,21026290,723593,20302697,2014.csv,2014,3.4413726815334513,96.55862731846655
1613,My Hero Academia: Two Heroes,21022724,5754556,15268168,2018.csv,2018,27.37302739644967,72.62697260355033
1614,The Infiltrator,21011110,15436808,5574302,2016.csv,2016,73.46974053250875,26.530259467491245
1615,Before Midnight,20994648,8114627,12880021,2013.csv,2013,38.650931418331,61.34906858166901
1616,71: Into the Fire,20967660,176638,20791022,2010.csv,2010,0.8424306765752593,99.15756932342474
1617,El nino,20918976,1237,20917739,2014.csv,2014,0.005913291358047353,99.99408670864194
1618,SuperFly,20780685,20545116,235569,2018.csv,2018,98.8664040670459,1.133595932954087
1619,The Photograph,20690779,20578185,112594,2020.csv,2020,99.45582522533347,0.5441747746665314
1620,Keanu,20651333,20591853,59480,2016.csv,2016,99.71197985137327,0.2880201486267254
1621,The Front Line,20629645,11018,20618627,2011.csv,2011,0.05340857780150846,99.9465914221985
1622,If Beale Street Could Talk,20596567,14915773,5680794,2018.csv,2018,72.4187336656638,27.581266334336203
1623,The Best Offer,20596350,100035,20496315,2013.csv,2013,0.48569285334537426,99.51430714665463
1624,Polisse,20590872,211440,20379432,2011.csv,2011,1.0268627768653993,98.9731372231346
1625,The Man with the Iron Fists,20546518,15634090,4912428,2012.csv,2012,76.09118975779741,23.9088102422026
1626,Race 2,20531909,1579940,18951969,2013.csv,2013,7.695046768422752,92.30495323157724
1627,Country Strong,20529194,20218921,310273,2010.csv,2010,98.48862551544887,1.5113744845511228
1628,Cock and Bull,20490872,82778,20408094,2016.csv,2016,0.4039749992094041,99.5960250007906
1629,The Sapphires,20423628,2450867,17972761,2012.csv,2012,12.000154918607016,87.99984508139298
1630,That Demon Within,20415934,172343,20243591,2014.csv,2014,0.8441592728503139,99.1558407271497
1631,The Clan,20381995,201227,20180768,2015.csv,2015,0.9872782325773312,99.01272176742268
1632,Burn the Stage: The Movie,20347513,4201819,16145694,2018.csv,2018,20.650282911724887,79.34971708827511
1633,Brahms: The Boy II,20311536,12611536,7700000,2020.csv,2020,62.090508566166534,37.909491433833466
1634,Cold War 2018 Re-release,20296042,4580048,15715994,2018.csv,2018,22.56621266353312,77.43378733646689
1635,Labor Day,20275812,13371528,6904284,2014.csv,2014,65.94817509651402,34.051824903485986
1636,Singh Is Bliing,20224851,919095,19305756,2015.csv,2015,4.5443845297055585,95.45561547029445
1637,The Bling Ring,20045576,5845732,14199844,2013.csv,2013,29.162205166865746,70.83779483313425
1638,The Company You Keep,20014680,5133027,14881653,2012.csv,2012,25.646310608013717,74.35368939198628
1639,The Wife,19978189,9601092,10377097,2018.csv,2018,48.05786950959369,51.94213049040631
1640,They Shall Not Grow Old,19866389,17956913,1909476,2018.csv,2018,90.38840928766673,9.611590712333278
1641,The Rooftop,19833152,85755,19747397,2013.csv,2013,0.43238210446831643,99.56761789553168
1642,Gone,19767535,11682205,8085330,2012.csv,2012,59.0979350738471,40.90206492615291
1643,It Comes at Night,19735344,13985117,5750227,2017.csv,2017,70.86330494163163,29.136695058368378
1644,Another Year,19722766,3205706,16517060,2010.csv,2010,16.25383579564854,83.74616420435146
1645,Brothers,19694450,613775,19080675,2015.csv,2015,3.116487132161599,96.8835128678384
1646,Blackhat,19652057,8005980,11646077,2015.csv,2015,40.738636164143024,59.26136383585698
1647,Youth in Revolt,19651093,15281286,4369807,2010.csv,2010,77.76303333356573,22.23696666643428
1648,The Guard,19561904,5360274,14201630,2011.csv,2011,27.401596490811936,72.59840350918806
1649,Puella Magi Madoka Magica the Movie Part III: The Rebellion Story,19544634,375627,19169007,2013.csv,2013,1.9218932418995411,98.07810675810046
1650,Margin Call,19504039,5354039,14150000,2011.csv,2011,27.450924395711063,72.54907560428893
1651,In This Corner of the World,19496308,172147,19324161,2016.csv,2016,0.8829723042947414,99.11702769570526
1652,Blue Is the Warmest Colour,19465835,2199787,17266048,2013.csv,2013,11.300758482746822,88.69924151725318
1653,Buried,19439764,1044143,18395621,2010.csv,2010,5.371171172654154,94.62882882734584
1654,The Edge of Seventeen,19370020,14431633,4938387,2016.csv,2016,74.50499792979048,25.495002070209534
1655,The Lost City of Z,19263938,8580410,10683528,2017.csv,2017,44.54130822057255,55.45869177942745
1656,Foxcatcher,19206513,12096300,7110213,2014.csv,2014,62.98019843581185,37.01980156418815
1657,Everybody Knows,19176163,2660165,16515998,2018.csv,2018,13.872248582784783,86.12775141721521
1658,My Annoying Brother,19162324,51996,19110328,2016.csv,2016,0.27134495794977687,99.72865504205022
1659,Oolong Courtyard: KungFu School,19129015,37727,19091288,2018.csv,2018,0.19722395533695805,99.80277604466305
1660,Shame,19123767,3909002,15214765,2011.csv,2011,20.44054395768365,79.55945604231634
1661,Norwegian Wood,19115721,13000,19102721,2010.csv,2010,0.0680068515333531,99.93199314846665
1662,Les Misérables,19082469,330181,18752288,2013.csv,2013,1.730284482579272,98.26971551742074
1663,Always Miss You,19015465,91884,18923581,2019.csv,2019,0.48320669518205317,99.51679330481795
1664,Memoir of a Murderer,19015346,91335,18924011,2017.csv,2017,0.4803225773541013,99.5196774226459
1665,Jo Nesbø's Headhunters,18962444,1200010,17762434,2011.csv,2011,6.32835092354129,93.6716490764587
1666,The Turning,18714343,15472775,3241568,2020.csv,2020,82.67869729650675,17.321302703493252
1667,Pina,18705853,3524826,15181027,2011.csv,2011,18.843439002754913,81.15656099724508
1668,13 Assassins,18689058,802778,17886280,2010.csv,2010,4.295443890216403,95.7045561097836
1669,Glee: The 3D Concert Movie,18663238,11862398,6800840,2011.csv,2011,63.560235367517684,36.439764632482316
1670,The Drop,18658381,10724389,7933992,2014.csv,2014,57.477596796849625,42.522403203150375
1671,Greta,18653107,10532219,8120888,2019.csv,2019,56.463617562478994,43.536382437521
1672,Peppa Celebrates Chinese New Year,18653040,131225,18521815,2019.csv,2019,0.7035046298083315,99.29649537019168
1673,Gekijouban Fate/Stay Night: Heaven's Feel - III. Spring Song,18650994,0,18650994,2020.csv,2020,0.0,100.0
1674,Admission,18637201,18007317,629884,2013.csv,2013,96.62028649044457,3.3797135095554314
1675,Detective K: Secret of the Living Dead,18603476,104013,18499463,2018.csv,2018,0.5591051908793819,99.44089480912062
1676,Battle of the Sexes,18598607,12638526,5960081,2017.csv,2017,67.95415377076358,32.04584622923641
1677,Black Christmas,18529730,10429730,8100000,2019.csv,2019,56.286465048330435,43.71353495166956
1678,Airpocalypse,18491089,105678,18385411,2018.csv,2018,0.5715077137966292,99.42849228620338
1679,Motherless Brooklyn,18477736,9277736,9200000,2019.csv,2019,50.21035044553077,49.78964955446923
1680,Zero,18412196,1035388,17376808,2018.csv,2018,5.6233813717820516,94.37661862821794
1681,Repo Men,18409891,13794835,4615056,2010.csv,2010,74.93164951384014,25.068350486159858
1682,The Wasted Times,18345372,386540,17958832,2016.csv,2016,2.1070164180917126,97.89298358190828
1683,Fabricated City,18307490,104874,18202616,2017.csv,2017,0.5728475066762292,99.42715249332377
1684,Asura,18300843,175702,18125141,2016.csv,2016,0.9600759921277944,99.0399240078722
1685,Chappaquiddick,18263470,17395520,867950,2018.csv,2018,95.24761723812615,4.7523827618738395
1686,The Case for Christ,18175663,14682684,3492979,2017.csv,2017,80.78210957146378,19.217890428536226
1687,Sorry to Bother You,18170707,17493096,677611,2018.csv,2018,96.27086056695538,3.729139433044625
1688,Hell Fest,18159691,11107431,7052260,2018.csv,2018,61.16530837446518,38.834691625534816
1689,The Lighthouse,18113964,10867104,7246860,2019.csv,2019,59.99296454381824,40.00703545618176
1690,Blinded by the Light,18096691,11901145,6195546,2019.csv,2019,65.76420517983095,34.235794820169055
1691,Dead Man Down,18074539,10895295,7179244,2013.csv,2013,60.27979468798623,39.72020531201377
1692,Kalank,17987034,2729336,15257698,2019.csv,2019,15.173908049542797,84.82609195045721
1693,Dope,17986781,17506470,480311,2015.csv,2015,97.32964447612945,2.670355523870558
1694,Cantinflas,17966873,6382924,11583949,2014.csv,2014,35.52607067462435,64.47392932537565
1695,We Have a Pope,17877523,548115,17329408,2011.csv,2011,3.0659448739067487,96.93405512609326
1696,Dil Dhadakne Do,17870077,3066100,14803977,2015.csv,2015,17.157732448494766,82.84226755150523
1697,The Old Man & the Gun,17860397,11277120,6583277,2018.csv,2018,63.14036580485865,36.859634195141346
1698,The Quiet Ones,17835162,8509867,9325295,2014.csv,2014,47.71398768343119,52.28601231656881
1699,Unforgettable,17768012,11368012,6400000,2017.csv,2017,63.980213430742836,36.01978656925716
1700,The Children Act,17696794,547750,17149044,2018.csv,2018,3.095193400567357,96.90480659943265
1701,Regression,17671101,55039,17616062,2015.csv,2015,0.31146333213759575,99.68853666786241
1702,Before I Go to Sleep,17669776,3242457,14427319,2014.csv,2014,18.350300535784946,81.64969946421505
1703,Neerja,17618280,1585687,16032593,2015.csv,2015,9.000237253579805,90.9997627464202
1704,Operation Finale,17612099,17612099,0,2018.csv,2018,100.0,0.0
1705,Little Boy,17572289,6485961,11086328,2015.csv,2015,36.91016577293943,63.08983422706057
1706,Toilet: A Love Story,17567417,1830715,15736702,2017.csv,2017,10.421082393615407,89.57891760638459
1707,Loving Pablo,17535962,22017,17513945,2018.csv,2018,0.12555341988081406,99.87444658011918
1708,Addicted,17534314,17390770,143544,2014.csv,2014,99.18135377295056,0.8186462270494301
1709,Machete Kills,17496820,8008161,9488659,2013.csv,2013,45.76923692419537,54.23076307580463
1710,Fate/Stay Night: Heaven's Feel - I. Presage Flower,17422935,193833,17229102,2017.csv,2017,1.1125163469874622,98.88748365301254
1711,Stolen,17415418,304318,17111100,2012.csv,2012,1.7474056608919752,98.25259433910803
1712,Kapoor & Sons,17412627,2607036,14805591,2016.csv,2016,14.972100418851216,85.02789958114877
1713,Billy and Buddy,17400053,894,17399159,2013.csv,2013,0.005137915384510611,99.99486208461549
1714,Fruitvale Station,17385830,16101339,1284491,2013.csv,2013,92.61185114544432,7.388148854555693
1715,Fate/stay night [Heaven's Feel] II. lost butterfly,17295864,420595,16875269,2019.csv,2019,2.431766345988845,97.56823365401117
1716,While We're Young,17287309,7587485,9699824,2015.csv,2015,43.89049215236449,56.10950784763551
1717,Legend of the Naga Pearls,17274695,13588,17261107,2017.csv,2017,0.07865840757246365,99.92134159242754
1718,My Afternoons with Margueritte,17107143,666557,16440586,2010.csv,2010,3.8963665645397363,96.10363343546027
1719,Digimon Adventure: Last Evolution Kizuna,17040162,0,17040162,2020.csv,2020,0.0,100.0
1720,Melancholia,17039814,3030848,14008966,2011.csv,2011,17.786860819020678,82.21313918097933
1721,Beyond Outrage,17027515,3878,17023637,2012.csv,2012,0.02277490285576022,99.97722509714424
1722,Chinese Puzzle,16968297,338523,16629774,2013.csv,2013,1.9950322651707475,98.00496773482925
1723,The Nutcracker in 3D,16918946,195459,16723487,2010.csv,2010,1.1552670006748649,98.84473299932513
1724,Calvary,16887741,3600006,13287735,2014.csv,2014,21.317273873397276,78.68272612660272
1725,The Last Godfather,16863629,164247,16699382,2010.csv,2010,0.9739718538637205,99.02602814613628
1726,The Cold Light of Day,16863583,3763583,13100000,2012.csv,2012,22.31781348008902,77.68218651991099
1727,The Pyramid,16861137,2756333,14104804,2014.csv,2014,16.347254636505237,83.65274536349476
1728,Monkey Kingdom,16839663,16432322,407341,2015.csv,2015,97.58106204381882,2.4189379561811895
1729,Hit and Run,16816647,13749300,3067347,2012.csv,2012,81.76005597310807,18.239944026891923
1730,Hardcore Henry,16810562,9252038,7558524,2016.csv,2016,55.03705349053768,44.96294650946233
1731,The Birth of a Nation,16779212,15861566,917646,2016.csv,2016,94.53105425928226,5.468945740717741
1732,102 Not Out,16758596,1343797,15414799,2018.csv,2018,8.018553582889641,91.98144641711036
1733,Baaghi 3,16726510,721439,16005071,2020.csv,2020,4.313147213614794,95.6868527863852
1734,Love Is All You Need,16722143,1631709,15090434,2012.csv,2012,9.757774467064419,90.24222553293558
1735,Delhi Belly,16706074,1532594,15173480,2011.csv,2011,9.173872927894369,90.82612707210563
1736,Pride,16699029,1446634,15252395,2014.csv,2014,8.662982739894638,91.33701726010536
1737,Mai wei,16653488,70177,16583311,2011.csv,2011,0.42139520561698546,99.57860479438303
1738,Beautiful Boy,16636604,7649973,8986631,2018.csv,2018,45.98277989907075,54.01722010092925
1739,Nothing to Lose 2,16610713,1150551,15460162,2019.csv,2019,6.926559985715243,93.07344001428476
1740,Belle,16607575,10726630,5880945,2014.csv,2014,64.5887795177803,35.411220482219704
1741,Upgrade,16593554,11977130,4616424,2018.csv,2018,72.17941376512832,27.820586234871687
1742,Tazza: One-Eyed Jack,16572611,97655,16474956,2019.csv,2019,0.5892553683906537,99.41074463160935
1743,Battle of the Year,16549477,8888355,7661122,2013.csv,2013,53.707769737980236,46.292230262019764
1744,"Tomorrow, When the War Began",16533595,4936,16528659,2010.csv,2010,0.029854366216179845,99.97014563378383
1745,Silent House,16527747,12754783,3772964,2012.csv,2012,77.17194001094039,22.82805998905961
1746,Pride and Prejudice and Zombies,16457494,10938134,5519360,2016.csv,2016,66.46293779599738,33.53706220400262
1747,Poms,16418218,13631124,2787094,2019.csv,2019,83.02438181780751,16.97561818219249
1748,Forever My Girl,16376066,16376066,0,2018.csv,2018,100.0,0.0
1749,Before I Fall,16373843,12241122,4132721,2017.csv,2017,74.76022580648905,25.239774193510954
1750,The Single Moms Club,16365451,15973881,391570,2014.csv,2014,97.60733755519479,2.392662444805218
1751,Little Q,16360233,1652,16358581,2019.csv,2019,0.01009765569964682,99.98990234430035
1752,Playmobil: The Movie,16349303,1115008,15234295,2019.csv,2019,6.819911527726901,93.1800884722731
1753,Macbeth,16322067,1110707,15211360,2015.csv,2015,6.804940820301743,93.19505917969826
1754,Gangnam 1970,16191434,18022,16173412,2015.csv,2015,0.11130576822287637,99.88869423177712
1755,In the House,16190771,389757,15801014,2012.csv,2012,2.407278813343725,97.59272118665628
1756,Scouts Guide to the Zombie Apocalypse,16137046,3703046,12434000,2015.csv,2015,22.94748369683026,77.05251630316974
1757,The Space Between Us,16080475,7885294,8195181,2017.csv,2017,49.03644948299102,50.96355051700898
1758,Unfriended: Dark Web,16024987,8866745,7158242,2018.csv,2018,55.33074691417846,44.66925308582154
1759,Sea Rex 3D: Journey to a Prehistoric World,16004150,6096582,9907568,2010.csv,2010,38.09375693179582,61.90624306820418
1760,The Kitchen,15980032,12180032,3800000,2019.csv,2019,76.2203229630579,23.779677036942104
1761,The Words,15950164,11494838,4455326,2012.csv,2012,72.06720883873044,27.932791161269567
1762,Wonder Wheel,15889124,1404061,14485063,2017.csv,2017,8.836616795236791,91.1633832047632
1763,The Hunt,15843274,613308,15229966,2012.csv,2012,3.8710938155838246,96.12890618441618
1764,"I, Daniel Blake",15793051,260354,15532697,2016.csv,2016,1.648535169043651,98.35146483095635
1765,Finding Your Feet,15775555,1418682,14356873,2018.csv,2018,8.992913403046677,91.00708659695333
1766,I Still Believe,15756972,9868521,5888451,2020.csv,2020,62.629552175379885,37.370447824620115
1767,I Hate Luv Storys,15719212,847993,14871219,2010.csv,2010,5.394627924096959,94.60537207590303
1768,The Brand New Testament,15709652,127910,15581742,2015.csv,2015,0.8142128164264872,99.18578718357351
1769,Feng Shui,15702302,64147,15638155,2018.csv,2018,0.4085197189558576,99.59148028104414
1770,Judy Moody and the Not Bummer Summer,15691640,15013650,677990,2011.csv,2011,95.6792916482917,4.320708351708298
1771,Out of the Furnace,15660668,11330849,4329819,2013.csv,2013,72.3522713079672,27.647728692032803
1772,The Divine Move 2: The Wrathful,15642991,67578,15575413,2019.csv,2019,0.4320017827792652,99.56799821722073
1773,Vampire Academy,15642346,7791979,7850367,2014.csv,2014,49.81336559106927,50.18663440893073
1774,Tully,15636462,9369755,6266707,2018.csv,2018,59.92247479001323,40.07752520998676
1775,The Conspirator,15623183,11538204,4084979,2011.csv,2011,73.85309382857514,26.14690617142486
1776,Paranoia,15500644,7388654,8111990,2013.csv,2013,47.66675500708229,52.33324499291771
1777,Chronicles of Evil,15460494,105057,15355437,2015.csv,2015,0.6795190373606432,99.32048096263935
1778,Our Little Sister,15407615,64441,15343174,2015.csv,2015,0.4182412398025262,99.58175876019747
1779,Anonymous,15395087,4463292,10931795,2011.csv,2011,28.99166467847827,71.00833532152173
1780,Miss Bala,15383580,15006824,376756,2019.csv,2019,97.5509211769952,2.4490788230047884
1781,When Harry Met Sejal,15360368,1664648,13695720,2017.csv,2017,10.837292439868628,89.16270756013137
1782,Apollo 11,15342353,9039891,6302462,2019.csv,2019,58.921151142852736,41.07884885714727
1783,The Dead Don't Die,15322395,6563605,8758790,2019.csv,2019,42.83667794754019,57.16332205245982
1784,The Negotiation,15229193,110986,15118207,2018.csv,2018,0.72877138007247,99.27122861992753
1785,Attack on Titan Part 2,15186410,305934,14880476,2015.csv,2015,2.014524828448593,97.9854751715514
1786,Spectacle,15159762,2065487,13094275,2015.csv,2015,13.624798331266676,86.37520166873333
1787,Extraordinary Measures,15134293,12068313,3065980,2010.csv,2010,79.74150493848639,20.25849506151361
1788,Irreplaceable,15130912,8494,15122418,2016.csv,2016,0.056136735181593816,99.94386326481842
1789,Three,15121228,119550,15001678,2016.csv,2016,0.7906103922247585,99.20938960777525
1790,War of the Buttons,15082409,47771,15034638,2011.csv,2011,0.3167332221265184,99.68326677787348
1791,Ip Man 2,15061802,205675,14856127,2010.csv,2010,1.3655404579080246,98.63445954209197
1792,Hanyo,15038301,157961,14880340,2010.csv,2010,1.050391264279123,98.94960873572087
1793,Journey to the South Pacific,14994876,7653913,7340963,2013.csv,2013,51.0435231341693,48.9564768658307
1794,Blue Valentine,14892418,9706328,5186090,2010.csv,2010,65.1763064936802,34.82369350631979
1795,Gold,14880939,7227038,7653901,2017.csv,2017,48.565739030312535,51.434260969687465
1796,School of Life,14880497,6300,14874197,2017.csv,2017,0.0423372955889847,99.957662704411
1797,Emperor,14858240,3346265,11511975,2013.csv,2013,22.521274390506544,77.47872560949345
1798,The Take,14857808,50269,14807539,2016.csv,2016,0.33833389151347226,99.66166610848653
1799,Somewhere,14788642,1785645,13002997,2010.csv,2010,12.074435232119352,87.92556476788064
1800,Dabangg 3,14784628,202000,14582628,2019.csv,2019,1.3662839538471985,98.6337160461528
1801,Seondal: The Man Who Sells the River,14777982,97477,14680505,2016.csv,2016,0.6596096814842514,99.34039031851574
1802,A Royal Affair,14758997,1546761,13212236,2012.csv,2012,10.480122734627564,89.51987726537244
1803,Made in India,14751915,790628,13961287,2018.csv,2018,5.359494004676681,94.64050599532332
1804,Sword Master,14714624,75526,14639098,2016.csv,2016,0.5132716948798691,99.48672830512012
1805,Inherent Vice,14710975,8110975,6600000,2014.csv,2014,55.13553656368799,44.86446343631201
1806,The Way Back,14690514,13590514,1100000,2020.csv,2020,92.51217486331656,7.4878251366834405
1807,"Hello, My Name Is Doris",14659448,14444999,214449,2016.csv,2016,98.5371277281382,1.4628722718618055
1808,Beyond the Lights,14618727,14618727,0,2014.csv,2014,100.0,0.0
1809,Megan Leavey,14510490,13406883,1103607,2017.csv,2017,92.39441948548946,7.605580514510536
1810,A United Kingdom,14459330,3902185,10557145,2016.csv,2016,26.9873154565253,73.01268454347469
1811,Serenity,14454622,8547045,5907577,2019.csv,2019,59.13018687033117,40.869813129668835
1812,America: Imagine the World Without Her,14444502,14444502,0,2014.csv,2014,100.0,0.0
1813,RBG,14441292,14017361,423931,2018.csv,2018,97.06445240495103,2.9355475950489747
1814,Unfinished Business,14431253,10219501,4211752,2015.csv,2015,70.81506366772172,29.184936332278284
1815,45 Years,14430249,4247285,10182964,2015.csv,2015,29.43320659262359,70.56679340737641
1816,Do You Believe?,14410698,12985600,1425098,2015.csv,2015,90.11083293814082,9.889167061859183
1817,Woodlawn,14401617,14394097,7520,2015.csv,2015,99.94778364123972,0.05221635876026977
1818,Eighth Grade,14347433,13539709,807724,2018.csv,2018,94.37025424687468,5.629745753125316
1819,Tall Tales from the Magical Garden of Antoon Krings,14340726,220,14340506,2017.csv,2017,0.0015340924859731648,99.99846590751402
1820,The Other Side of the Door,14332467,3000342,11332125,2016.csv,2016,20.933883887540087,79.06611611245992
1821,Beginners,14311701,5790894,8520807,2011.csv,2011,40.462653600714546,59.537346399285454
1822,The Beauty Inside,14301869,108083,14193786,2015.csv,2015,0.7557264019129248,99.24427359808708
1823,Unsane,14293601,7732899,6560702,2018.csv,2018,54.10042577794078,45.89957422205922
1824,Colette,14273033,5137622,9135411,2018.csv,2018,35.99530667378124,64.00469332621876
1825,La Belle Époque,14233465,0,14233465,2019.csv,2019,0.0,100.0
1826,Ya veremos,14134723,4165949,9968774,2018.csv,2018,29.473156283289033,70.52684371671096
1827,Shaandaar,14120808,521794,13599014,2015.csv,2015,3.695213475036273,96.30478652496373
1828,Red Lights,14107313,52624,14054689,2012.csv,2012,0.37302638709440983,99.62697361290559
1829,Seeking Justice,14089528,411746,13677782,2011.csv,2011,2.922354815576505,97.0776451844235
1830,Island of Lemurs: Madagascar,14066534,11272213,2794321,2014.csv,2014,80.13497141513325,19.86502858486675
1831,The Personal History of David Copperfield,14056678,1876298,12180380,2020.csv,2020,13.34808978337556,86.65191021662444
1832,Kedarnath,13999297,901131,13098166,2018.csv,2018,6.436973228012807,93.5630267719872
1833,The Quake,13837294,6235,13831059,2018.csv,2018,0.04505938805665327,99.95494061194334
1834,Winter's Bone,13796834,6531503,7265331,2010.csv,2010,47.34059277657469,52.65940722342531
1835,Pulling Strings,13725819,5842961,7882858,2013.csv,2013,42.569124654783806,57.430875345216194
1836,Tees Maar Khan,13681934,1076443,12605491,2010.csv,2010,7.867623100652291,92.13237689934772
1837,Phantom,13676590,489984,13186606,2015.csv,2015,3.582647428927825,96.41735257107217
1838,The Bride of Humpty Sharma,13669988,380011,13289977,2014.csv,2014,2.7798927109519043,97.2201072890481
1839,Chloe,13657649,3075255,10582394,2010.csv,2010,22.51672304655069,77.4832769534493
1840,All Is Lost,13627519,6263670,7363849,2013.csv,2013,45.96339216257926,54.03660783742074
1841,Sing Street,13624522,3237118,10387404,2016.csv,2016,23.759497764398635,76.24050223560137
1842,Do It Like An Hombre,13610252,2534252,11076000,2017.csv,2017,18.620169560416663,81.37983043958333
1843,Love Forecast,13608637,32211,13576426,2015.csv,2015,0.23669526933520232,99.7633047306648
1844,Strange Magic,13603453,12429583,1173870,2015.csv,2015,91.37079387123255,8.629206128767454
1845,The Two Faces of January,13551951,507463,13044488,2014.csv,2014,3.744575227581623,96.25542477241838
1846,Nymphomaniac: Vol. I,13545832,785896,12759936,2013.csv,2013,5.801755108139537,94.19824489186045
1847,Phantom of the Theatre,13526843,43955,13482888,2016.csv,2016,0.32494647864250364,99.6750535213575
1848,Three Identical Strangers,13448497,12320845,1127652,2018.csv,2018,91.6150332635684,8.384966736431586
1849,The Third Murder,13411936,89315,13322621,2017.csv,2017,0.6659366701421778,99.33406332985783
1850,The Witches,13400000,0,13400000,2020.csv,2020,0.0,100.0
1851,Our President,13392049,507268,12884781,2017.csv,2017,3.7878296293569416,96.21217037064305
1852,Ratchet & Clank,13385737,8821329,4564408,2016.csv,2016,65.90095860989948,34.099041390100524
1853,Hotel Artemis,13313581,6708147,6605434,2018.csv,2018,50.38574520258674,49.61425479741326
1854,Paris Can Wait,13203541,5617731,7585810,2017.csv,2017,42.54715458527375,57.45284541472625
1855,The Well Digger's Daughter,13194167,386368,12807799,2011.csv,2011,2.9283243117962656,97.07167568820373
1856,Mommy,13156856,3494070,9662786,2014.csv,2014,26.55702851805933,73.44297148194066
1857,The Sisters Brothers,13143056,3143056,10000000,2018.csv,2018,23.914194689576,76.085805310424
1858,Hillary's America: The Secret History of the Democratic Party,13099931,13099931,0,2016.csv,2016,100.0,0.0
1859,The Angels' Share,13090471,346669,12743802,2012.csv,2012,2.6482545967979303,97.35174540320207
1860,Shut In,13082071,6900335,6181736,2016.csv,2016,52.74650321038619,47.25349678961381
1861,Hot Tub Time Machine 2,13081651,12314651,767000,2015.csv,2015,94.136825695778,5.863174304221998
1862,Welcome to Marwen,13061491,10763520,2297971,2018.csv,2018,82.40651852074163,17.59348147925838
1863,"Roman J. Israel, Esq.",13025860,11962778,1063082,2017.csv,2017,91.83868090091556,8.161319099084437
1864,Friends with Kids,13019073,7251073,5768000,2012.csv,2012,55.69577035169861,44.30422964830138
1865,The Vatican Tapes,13015764,1784763,11231001,2015.csv,2015,13.712318385613015,86.28768161438698
1866,In a Better World,13004504,1008098,11996406,2010.csv,2010,7.751914259859507,92.2480857401405
1867,Pyaar Ka Punchnama 2,12983721,222856,12760865,2015.csv,2015,1.7164262848839713,98.28357371511602
1868,The Wave,12975143,177404,12797739,2015.csv,2015,1.3672604610215087,98.63273953897848
1869,I Saw the Devil,12966357,129210,12837147,2010.csv,2010,0.996501947308716,99.00349805269128
1870,Le Havre,12959706,611709,12347997,2011.csv,2011,4.720083927829844,95.27991607217015
1871,Loving,12957265,7751969,5205296,2016.csv,2016,59.82720118790501,40.17279881209499
1872,Child 44,12951093,1224330,11726763,2015.csv,2015,9.453487825313276,90.54651217468673
1873,Take Point,12908032,112386,12795646,2018.csv,2018,0.8706671938836221,99.12933280611638
1874,Mubarakan,12899968,758868,12141100,2017.csv,2017,5.882712267193221,94.11728773280677
1875,Earth: One Amazing Day,12851540,81345,12770195,2017.csv,2017,0.6329591628707532,99.36704083712925
1876,Suburbicon,12751667,5775178,6976489,2017.csv,2017,45.28959233330042,54.71040766669958
1877,Elle,12748594,2341534,10407060,2016.csv,2016,18.366997960716294,81.63300203928371
1878,Populaire,12698385,179091,12519294,2012.csv,2012,1.4103447013143797,98.58965529868561
1879,The Past,12673462,1331747,11341715,2013.csv,2013,10.50815475676654,89.49184524323346
1880,Redemption,12671109,36895,12634214,2013.csv,2013,0.29117419793326693,99.70882580206674
1881,The Green Inferno,12666449,7192291,5474158,2015.csv,2015,56.782220494473236,43.217779505526764
1882,Made in Dagenham,12629471,1095369,11534102,2010.csv,2010,8.673118612806507,91.3268813871935
1883,Luis and the Aliens,12627729,169710,12458019,2018.csv,2018,1.3439471182823135,98.65605288171768
1884,Their Finest,12597262,3603484,8993778,2017.csv,2017,28.60529534116223,71.39470465883777
1885,People Like Us,12558931,12434778,124153,2012.csv,2012,99.01143656255456,0.9885634374454323
1886,The Promise,12448676,8224288,4224388,2017.csv,2017,66.06556392021128,33.934436079788725
1887,Can You Ever Forgive Me?,12442161,8803865,3638296,2018.csv,2018,70.7583272712835,29.2416727287165
1888,Rampant,12359573,167937,12191636,2018.csv,2018,1.3587605332320138,98.64123946676798
1889,Marrowbone,12294931,1377,12293554,2017.csv,2017,0.011199737517843736,99.98880026248216
1890,The Beatles: Eight Days a Week - The Touring Years,12283800,2930414,9353386,2016.csv,2016,23.855924062586496,76.1440759374135
1891,The Man Who Knew Infinity,12252684,3866794,8385890,2016.csv,2016,31.558750719434208,68.4412492805658
1892,Gainsbourg: A Heroic Life,12220456,233007,11987449,2010.csv,2010,1.90669644406068,98.09330355593931
1893,The Guillotines,12217440,5290,12212150,2012.csv,2012,0.04329875980565487,99.95670124019435
1894,The Current War: Director's Cut,12217160,5979540,6237620,2019.csv,2019,48.94378071499432,51.056219285005675
1895,I Married an Anti-Fan,12194083,89408,12104675,2016.csv,2016,0.7332080649278835,99.26679193507212
1896,Little Women,12165890,1379497,10786393,2018.csv,2018,11.339055342436929,88.66094465756306
1897,Miss & Mrs. Cops,12147170,104578,12042592,2019.csv,2019,0.8609248080005466,99.13907519199945
1898,Bachelorette,12128575,447954,11680621,2012.csv,2012,3.693377004305947,96.30662299569406
1899,Barney's Version,12104765,4439201,7665564,2011.csv,2011,36.67316961543657,63.326830384563436
1900,Stoker,12077441,1714221,10363220,2012.csv,2012,14.193577927642123,85.80642207235788
1901,The Connection,12062441,190980,11871461,2014.csv,2014,1.5832616300465219,98.41673836995348
1902,The Bookshop,12055868,1588150,10467718,2017.csv,2017,13.173253058178805,86.8267469418212
1903,Tamara Drewe,12037973,560391,11477582,2010.csv,2010,4.655194026436178,95.34480597356382
1904,I Am Love,12014663,5005465,7009198,2010.csv,2010,41.66130169443787,58.33869830556213
1905,A Most Violent Year,12007070,5749134,6257936,2014.csv,2014,47.881239969451336,52.11876003054867
1906,The Assassin,11991669,632542,11359127,2015.csv,2015,5.274845394748637,94.72515460525136
1907,Mere Brother Ki Dulhan,11983381,496172,11487209,2011.csv,2011,4.140500915392742,95.85949908460726
1908,This Must Be the Place,11928909,143979,11784930,2011.csv,2011,1.2069754241565593,98.79302457584343
1909,The Warring States,11868961,68961,11800000,2011.csv,2011,0.5810196865589161,99.41898031344108
1910,Viceroy's House,11868221,1105717,10762504,2017.csv,2017,9.316619567498785,90.68338043250121
1911,Ballon,11859396,34222,11825174,2018.csv,2018,0.2885644429109206,99.71143555708908
1912,Boy Erased,11853081,6788692,5064389,2018.csv,2018,57.27364893566491,42.72635106433509
1913,Unstoppable,11845347,101417,11743930,2018.csv,2018,0.8561758469380424,99.14382415306196
1914,Kites,11844500,1643486,10201014,2010.csv,2010,13.875520283675968,86.12447971632403
1915,Wo zhi nv ren xin,11838177,123526,11714651,2011.csv,2011,1.0434545791974559,98.95654542080254
1916,Last Letter,11834622,180946,11653676,2018.csv,2018,1.5289546214488303,98.47104537855117
1917,Ash Is Purest White,11813509,422814,11390695,2018.csv,2018,3.579072060638376,96.42092793936162
1918,Getaway,11806432,10501938,1304494,2013.csv,2013,88.9509887491835,11.049011250816504
1919,The Divine Fury,11799556,102982,11696574,2019.csv,2019,0.87276165306559,99.1272383469344
1920,Win Win,11789613,10179275,1610338,2011.csv,2011,86.34104444310428,13.65895555689572
1921,Toni Erdmann,11784207,1479387,10304820,2016.csv,2016,12.553980085380372,87.44601991461963
1922,The Interview,11782625,6105175,5677450,2014.csv,2014,51.81506667656826,48.18493332343175
1923,C'est Si Bon,11750035,164167,11585868,2015.csv,2015,1.397161795688268,98.60283820431172
1924,Seeking a Friend for the End of the World,11681781,7078738,4603043,2012.csv,2012,60.59639364922182,39.40360635077819
1925,Bring the Soul: The Movie,11641119,4809800,6831319,2019.csv,2019,41.31733384050108,58.68266615949893
1926,Back to Burgundy,11625884,257610,11368274,2017.csv,2017,2.215831501501305,97.78416849849869
1927,The Lunchbox 2013 Re-release,11621581,4235151,7386430,2013.csv,2013,36.44212435468118,63.55787564531883
1928,Delicacy,11597420,498584,11098836,2011.csv,2011,4.2990941088621435,95.70090589113785
1929,Haute Cuisine,11509942,217883,11292059,2012.csv,2012,1.892998244474212,98.10700175552579
1930,Fists of Legend,11478881,134213,11344668,2013.csv,2013,1.1692167555356658,98.83078324446434
1931,Double Dhamaal,11445869,543646,10902223,2011.csv,2011,4.74971363030627,95.25028636969373
1932,Trumbo,11430025,7857741,3572284,2015.csv,2015,68.74649005579603,31.253509944203973
1933,Seasons,11425100,150092,11275008,2016.csv,2016,1.3137040376014213,98.68629596239857
1934,Fun Size,11417362,9409538,2007824,2012.csv,2012,82.414291497458,17.585708502542005
1935,The King's Case Note,11383493,90959,11292534,2017.csv,2017,0.7990429651074586,99.20095703489254
1936,King of Thieves,11353515,7518,11345997,2018.csv,2018,0.06621737849467764,99.93378262150532
1937,Bajirao Mastani,11350917,6557047,4793870,2015.csv,2015,57.7666720671114,42.23332793288859
1938,The Apparition,11350665,4936819,6413846,2012.csv,2012,43.49365433655209,56.50634566344791
1939,Snow Flower and the Secret Fan,11348205,1348205,10000000,2011.csv,2011,11.880337022463024,88.11966297753698
1940,"It's Not You, It's Me",11301956,1339911,9962045,2010.csv,2010,11.855567301801564,88.14443269819844
1941,Tomorrow,11277905,62510,11215395,2015.csv,2015,0.554269609470908,99.44573039052909
1942,At Eternity's Gate,11235662,2294915,8940747,2018.csv,2018,20.425276232054685,79.57472376794531
1943,Straw Dogs,11168712,10324441,844271,2010.csv,2010,92.44074876315192,7.55925123684808
1944,Ida,11156836,3827060,7329776,2013.csv,2013,34.3023774840824,65.6976225159176
1945,Gloria Bell,11145006,5611123,5533883,2019.csv,2019,50.34652291797779,49.653477082022206
1946,Bicycling with Molière,11123929,59874,11064055,2013.csv,2013,0.5382450750989152,99.46175492490109
1947,We Are Your Friends,11122090,3591417,7530673,2015.csv,2015,32.29084641465768,67.70915358534232
1948,Conviction 2010 Re-release,11104555,6783129,4321426,2010.csv,2010,61.08420373441349,38.91579626558651
1949,The Warrior's Way,11103434,5666340,5437094,2010.csv,2010,51.032320271368306,48.9676797286317
1950,The Belko Experiment,11084630,10166820,917810,2017.csv,2017,91.71997621932351,8.280023780676487
1951,Action Jackson,11060963,256872,10804091,2014.csv,2014,2.3223294391274973,97.6776705608725
1952,Promised Land,11039031,7597898,3441133,2012.csv,2012,68.82758097155448,31.172419028445518
1953,Last Night,11027222,99000,10928222,2010.csv,2010,0.8977782436954657,99.10222175630453
1954,"Where'd You Go, Bernadette",11025353,9198356,1826997,2019.csv,2019,83.4291292079265,16.570870792073507
1955,La boda de Valentina,11021794,2783739,8238055,2018.csv,2018,25.25667781488204,74.74332218511796
1956,The Loft,11016443,6002684,5013759,2014.csv,2014,54.48840428802655,45.511595711973456
1957,Gringo,11001627,4969853,6031774,2018.csv,2018,45.17380020246096,54.82619979753903
1958,[REC] 3: Genesis,10998667,9600,10989067,2012.csv,2012,0.08728330442225408,99.91271669557774
1959,Hyde Park on Hudson,10980481,6376145,4604336,2012.csv,2012,58.06799356057353,41.932006439426466
1960,Justin Bieber's Believe,10980157,6206566,4773591,2013.csv,2013,56.525293764014485,43.474706235985515
1961,Friend Request,10975390,3759078,7216312,2016.csv,2016,34.25006309570776,65.74993690429224
1962,The Florida Project,10971298,5904366,5066932,2017.csv,2017,53.8164764096281,46.18352359037189
1963,Jonah Hex,10903312,10547117,356195,2010.csv,2010,96.73314860658853,3.26685139341147
1964,One Chance,10900434,101196,10799238,2013.csv,2013,0.9283667053990694,99.07163329460093
1965,A Bag of Marbles,10898998,411318,10487680,2017.csv,2017,3.7739065554466564,96.22609344455334
1966,The Darkness,10898293,10753574,144719,2016.csv,2016,98.67209479502891,1.3279052049710904
1967,The Hunt,10891670,5812500,5079170,2020.csv,2020,53.36647180827183,46.633528191728175
1968,Only You,10857889,61565,10796324,2015.csv,2015,0.5670070858156682,99.43299291418434
1969,Danny Collins,10835752,5637066,5198686,2015.csv,2015,52.02284068516887,47.97715931483113
1970,Flying Monsters 3D with David Attenborough,10813862,5705874,5107988,2011.csv,2011,52.76444252756324,47.23555747243677
1971,Golden Slumber,10733326,94450,10638876,2018.csv,2018,0.8799695453208073,99.1200304546792
1972,Our Kind of Traitor,10711027,3153157,7557870,2016.csv,2016,29.43841893032293,70.56158106967708
1973,Prom,10702246,10130219,572027,2011.csv,2011,94.65507520570917,5.344924794290843
1974,Impractical Jokers: The Movie,10691091,10691091,0,2020.csv,2020,100.0,0.0
1975,The Sessions,10656155,6002451,4653704,2012.csv,2012,56.3284880897472,43.67151191025281
1976,Red Joan,10647493,1579730,9067763,2018.csv,2018,14.836638070576802,85.1633619294232
1977,Only God Forgives,10635126,779188,9855938,2013.csv,2013,7.326551655335348,92.67344834466465
1978,My Old Lady,10606667,4013786,6592881,2014.csv,2014,37.84210440471074,62.15789559528927
1979,The Phone,10551318,40516,10510802,2015.csv,2015,0.38398994324690056,99.6160100567531
1980,Moms' Night Out,10536956,10429707,107249,2014.csv,2014,98.98216334964292,1.017836650357086
1981,Get Low,10522511,9176933,1345578,2010.csv,2010,87.21238685329006,12.787613146709944
1982,The Leisure Seeker,10472180,3226443,7245737,2017.csv,2017,30.809659497831397,69.1903405021686
1983,Mood Indigo,10435322,303187,10132135,2013.csv,2013,2.9053918987837655,97.09460810121624
1984,Furious,10433259,9996,10423263,2017.csv,2017,0.09580898931005163,99.90419101068994
1985,Every Day,10421847,6102076,4319771,2018.csv,2018,58.55081157879213,41.44918842120787
1986,The Perfect Match,10414738,9669521,745217,2016.csv,2016,92.84459196189093,7.155408038109072
1987,Swing Kids,10397408,222001,10175407,2018.csv,2018,2.13515714685814,97.86484285314187
1988,Lobster Cop,10373129,85693,10287436,2018.csv,2018,0.8261056042010082,99.173894395799
1989,Queen of Katwe,10367161,8874389,1492772,2016.csv,2016,85.60095671322168,14.399043286778317
1990,I'm Your Hero,10338463,274579,10063884,2014.csv,2014,2.6558976900144633,97.34410230998553
1991,Kin,10313019,5718096,4594923,2018.csv,2018,55.44541321993104,44.55458678006896
1992,The Babadook,10312540,964413,9348127,2014.csv,2014,9.351847362531442,90.64815263746856
1993,3-D Sex and Zen: Extreme Ecstasy,10306807,153215,10153592,2011.csv,2011,1.4865418553000944,98.51345814469991
1994,Stone,10300416,1810078,8490338,2010.csv,2010,17.572863076598072,82.42713692340193
1995,English Vinglish,10299150,1862086,8437064,2012.csv,2012,18.079996892947474,81.92000310705252
1996,Girls vs Gangsters,10265819,37115,10228704,2018.csv,2018,0.36153959075257414,99.63846040924743
1997,Chennai Express,10234653,5307960,4926693,2013.csv,2013,51.862627878053125,48.13737212194688
1998,The Miracle Season,10230620,10230620,0,2018.csv,2018,100.0,0.0
1999,Babies,10219306,7320323,2898983,2010.csv,2010,71.63229088159216,28.367709118407845
2000,The Best of Enemies,10209813,10205616,4197,2019.csv,2019,99.95889248902013,0.04110751097987789
2001,My Spy,10200000,0,10200000,2020.csv,2020,0.0,100.0
2002,Senna,10197661,1612430,8585231,2010.csv,2010,15.811763109207103,84.1882368907929
2003,BTS World Tour: Love Yourself in Seoul,10195760,3509917,6685843,2019.csv,2019,34.425261088923236,65.57473891107676
2004,For Greater Glory: The True Story of Cristiada,10173682,5672846,4500836,2012.csv,2012,55.7600090114867,44.239990988513306
2005,Ben Is Back,10134204,3703184,6431020,2018.csv,2018,36.541439268441806,63.4585607315582
2006,Trespass,10117966,24094,10093872,2011.csv,2011,0.23813086543283501,99.76186913456716
2007,Marshall,10116816,10051659,65157,2017.csv,2017,99.35595349366835,0.6440465063316364
2008,Iron Sky,10109659,122082,9987577,2012.csv,2012,1.2075778223578064,98.7924221776422
2009,Bernie,10090641,9206470,884171,2012.csv,2012,91.23771225237326,8.762287747626736
2010,A Little Chaos,10084623,558173,9526450,2015.csv,2015,5.534892082728328,94.46510791727167
2011,Gladiators of Rome,10079201,8201,10071000,2012.csv,2012,0.0813655764975815,99.91863442350241
2012,Papillon,10060903,2335896,7725007,2018.csv,2018,23.217558105867834,76.78244189413218
2013,The King's Choice,10017316,113231,9904085,2016.csv,2016,1.1303526812970661,98.86964731870293
2014,Thank You for Your Service,9995692,9536300,459392,2017.csv,2017,95.40410008631719,4.595899913682815
2015,Alan Partridge,9979601,153426,9826175,2013.csv,2013,1.5373961343745106,98.46260386562548
2016,Cyrus,9933873,7468936,2464937,2010.csv,2010,75.18654607321838,24.81345392678163
2017,The Goldfinch,9932621,5332621,4600000,2019.csv,2019,53.68795406569927,46.31204593430073
2018,The Collection,9929706,6842058,3087648,2012.csv,2012,68.90494038796314,31.095059612036852
2019,Portrait of a Lady on Fire,9919850,3759854,6159996,2019.csv,2019,37.90232715212428,62.09767284787573
2020,Never Let Me Go,9904795,2434652,7470143,2010.csv,2010,24.580539021756636,75.41946097824336
2021,The Princess and the Matchmaker,9899017,78900,9820117,2018.csv,2018,0.7970488382836397,99.20295116171636
2022,Arctic Dogs,9877855,5801249,4076606,2019.csv,2019,58.72984570030639,41.27015429969361
2023,Young & Beautiful,9757417,61067,9696350,2013.csv,2013,0.6258521081962573,99.37414789180374
2024,Tamjung Hong Gil-dong: Sarajin Ma-eul,9754195,67054,9687141,2016.csv,2016,0.6874375589169583,99.31256244108305
2025,Maudie,9733932,6170998,3562934,2017.csv,2017,63.39676504828675,36.60323495171324
2026,Popstar: Never Stop Never Stopping,9680029,9639125,40904,2016.csv,2016,99.57743928246497,0.42256071753504043
2027,Tod@s Caen,9667157,2670925,6996232,2019.csv,2019,27.62885717072765,72.37114282927234
2028,In Darkness,9661759,1041455,8620304,2012.csv,2012,10.779144874137307,89.2208551258627
2029,Overdrive,9650552,7793,9642759,2017.csv,2017,0.08075185751032687,99.91924814248966
2030,On the Road,9617377,744296,8873081,2012.csv,2012,7.739074801788472,92.26092519821152
2031,Paterson,9588282,2152738,7435544,2016.csv,2016,22.451759345417667,77.54824065458233
2032,Hysteria,9584256,1804139,7780117,2011.csv,2011,18.82398592024253,81.17601407975746
2033,God of War,9559524,53000,9506524,2017.csv,2017,0.5544209104972172,99.44557908950277
2034,Agent Vinod,9520886,698210,8822676,2012.csv,2012,7.3334561510346825,92.66654384896532
2035,Traffik,9515914,9186156,329758,2018.csv,2018,96.53466813592473,3.4653318640752744
2036,The Young and Prodigious T.S. Spivet,9494789,173564,9321225,2013.csv,2013,1.8279921754975281,98.17200782450247
2037,The Square,9493791,1502347,7991444,2017.csv,2017,15.824521521487043,84.17547847851296
2038,Point Blank,9487445,708215,8779230,2010.csv,2010,7.464760006513872,92.53523999348613
2039,Our Time Will Come,9484714,114560,9370154,2017.csv,2017,1.2078382120957996,98.79216178790419
2040,The Mayor 2017 Re-release,9476194,96777,9379417,2017.csv,2017,1.0212644443539252,98.97873555564608
2041,Official Secrets,9473603,1988546,7485057,2019.csv,2019,20.990387712045777,79.00961228795423
2042,Promare,9467336,2313596,7153740,2019.csv,2019,24.43766651991648,75.56233348008352
2043,Peepli [Live],9460931,757951,8702980,2010.csv,2010,8.011378584200646,91.98862141579936
2044,Come Play,9435603,7504665,1930938,2020.csv,2020,79.53561632468005,20.464383675319954
2045,The Big Bad Fox and Other Tales,9399067,35787,9363280,2017.csv,2017,0.38075055747554515,99.61924944252446
2046,Bel Ami,9374932,120462,9254470,2012.csv,2012,1.284937320078695,98.7150626799213
2047,You Were Never Really Here,9360514,2528078,6832436,2017.csv,2017,27.00789721590075,72.99210278409925
2048,Jexi,9341824,6546159,2795665,2019.csv,2019,70.07367083772932,29.926329162270665
2049,Saving Private Perez,9330465,1400726,7929739,2011.csv,2011,15.012392201246133,84.98760779875387
2050,Replicas,9330075,4046429,5283646,2018.csv,2018,43.36973711358162,56.63026288641838
2051,MacGruber,9322895,8525600,797295,2010.csv,2010,91.44798906348296,8.552010936517036
2052,Peeples,9307166,9177065,130101,2013.csv,2013,98.60214161861946,1.3978583813805405
2053,Mid90s,9303022,7362439,1940583,2018.csv,2018,79.14029441185886,20.859705588141146
2054,Jerusalem,9279456,8020721,1258735,2013.csv,2013,86.43525008362559,13.564749916374408
2055,The Chef,9245235,342667,8902568,2012.csv,2012,3.706417413943507,96.29358258605649
2056,We Need to Talk About Kevin,9232318,1738692,7493626,2011.csv,2011,18.832670191819652,81.16732980818036
2057,The Aftermath,9215591,1618497,7597094,2019.csv,2019,17.562595822666175,82.43740417733383
2058,Tulip Fever,9204549,2455635,6748914,2017.csv,2017,26.67849342754327,73.32150657245673
2059,My Cousin Rachel,9200168,2716368,6483800,2017.csv,2017,29.525199974609162,70.47480002539083
2060,Corpus Christi,9174321,127240,9047081,2019.csv,2019,1.3869146283414326,98.61308537165857
2061,A Hologram for the King,9169507,4212494,4957013,2016.csv,2016,45.940245206203564,54.05975479379644
2062,Unfinished Song,9166865,1702668,7464197,2013.csv,2013,18.57415812276062,81.42584187723938
2063,The Raid: Redemption,9148519,4105187,5043332,2012.csv,2012,44.87269469517416,55.127305304825846
2064,Ruby Sparks,9128263,2540106,6588157,2012.csv,2012,27.82682751362444,72.17317248637556
2065,My Piece of the Pie,9123187,6850,9116337,2011.csv,2011,0.07508341109307526,99.92491658890692
2066,Searching for Sugar Man,9122406,3696196,5426210,2012.csv,2012,40.517775683301096,59.482224316698904
2067,City Of Rock,9118873,312537,8806336,2017.csv,2017,3.4273643245168564,96.57263567548314
2068,Human Capital,9113941,158549,8955392,2014.csv,2014,1.739631625879518,98.26036837412047
2069,Miss Sloane,9101546,3500605,5600941,2016.csv,2016,38.46165255880704,61.538347441192954
2070,Inception 10th Anniversary re-release,9100000,0,9100000,2020.csv,2020,0.0,100.0
2071,Meet the Blacks,9097072,9097072,0,2016.csv,2016,100.0,0.0
2072,Tolkien,9090040,4535154,4554886,2019.csv,2019,49.89146362392245,50.10853637607755
2073,Murder 2,9078349,59000,9019349,2011.csv,2011,0.6498979054451421,99.35010209455486
2074,Twice Born,9075131,18295,9056836,2012.csv,2012,0.2015948860683113,99.7984051139317
2075,Me and Earl and the Dying Girl,9074749,6758416,2316333,2015.csv,2015,74.47496343976016,25.52503656023985
2076,Monsieur Lazhar,9074711,2009517,7065194,2012.csv,2012,22.144143212935376,77.85585678706462
2077,Anjaana Anjaani,9062995,854757,8208238,2010.csv,2010,9.431286235951802,90.5687137640482
2078,The Fifth Estate,9058564,3255008,5803556,2013.csv,2013,35.932935948788355,64.06706405121166
2079,Frances Ha,9058065,4069826,4988239,2013.csv,2013,44.93041284203635,55.06958715796365
2080,Incarnate,9037058,4799774,4237284,2016.csv,2016,53.112130075960565,46.887869924039435
2081,Like Crazy,9029150,107362,8921788,2016.csv,2016,1.1890598782831163,98.81094012171688
2082,Truman,9027600,210840,8816760,2015.csv,2015,2.335504453010767,97.66449554698924
2083,"Two Days, One Night",9016922,1436243,7580679,2014.csv,2014,15.928306799149421,84.07169320085059
2084,Champion,8974547,97472,8877075,2018.csv,2018,1.0860938162115592,98.91390618378844
2085,The Lobster 2016 Re-release,8952351,8700374,251977,2016.csv,2016,97.18535388078506,2.8146461192149417
2086,Downhill,8899195,8287061,612134,2020.csv,2020,93.12146772826081,6.878532271739185
2087,Hannah Arendt,8880936,717205,8163731,2013.csv,2013,8.075781651843904,91.92421834815609
2088,Bluebeard,8855737,43144,8812593,2017.csv,2017,0.48718700656986536,99.51281299343013
2089,All Together,8835903,43180,8792723,2012.csv,2012,0.4886880265661585,99.51131197343385
2090,Morgan,8809407,3915251,4894156,2016.csv,2016,44.44397903286793,55.55602096713207
2091,Captive State,8808611,5958315,2850296,2019.csv,2019,67.64193582847511,32.35806417152489
2092,The Traitor,8780845,296027,8484818,2019.csv,2019,3.37128146550816,96.62871853449184
2093,7 Days in Entebbe,8771432,3326885,5444547,2018.csv,2018,37.9286415262639,62.071358473736105
2094,Sorry We Missed You,8768505,28273,8740232,2019.csv,2019,0.32243808950328473,99.67756191049672
2095,Marguerite,8754356,506677,8247679,2015.csv,2015,5.78771299682124,94.21228700317876
2096,La folle histoire de Max et Léon,8750678,543,8750135,2016.csv,2016,0.006205233468766649,99.99379476653122
2097,The Villainess,8737458,27741,8709717,2017.csv,2017,0.31749508838840773,99.68250491161159
2098,Reservation,8726551,651096,8075455,2011.csv,2011,7.461092016765845,92.53890798323415
2099,Code Geass: Lelouch of the Re;Surrection 2019 Re-release,8715612,522805,8192807,2019.csv,2019,5.998488689032968,94.00151131096703
2100,Mardaani 2,8680109,0,8680109,2019.csv,2019,0.0,100.0
2101,Le Week-end,8652213,2225098,6427115,2013.csv,2013,25.717096886079897,74.28290311392011
2102,Himmatwala,8644563,270880,8373683,2013.csv,2013,3.133530289501042,96.86646971049896
2103,Pope Francis: A Man of His Word,8608385,2008385,6600000,2018.csv,2018,23.330566651003643,76.66943334899635
2104,Space Dogs,8530226,14408,8515818,2010.csv,2010,0.16890525526521807,99.83109474473478
2105,Our Brand Is Crisis,8527658,7002261,1525397,2015.csv,2015,82.11235722633342,17.887642773666578
2106,What If,8526288,3493000,5033288,2014.csv,2014,40.96741747405201,59.03258252594799
2107,Stronger,8503658,4211129,4292529,2017.csv,2017,49.5213824450607,50.4786175549393
2108,Piranha 3DD,8493728,376512,8117216,2012.csv,2012,4.432823843664408,95.56717615633559
2109,Amityville: The Awakening,8481997,742,8481255,2017.csv,2017,0.008747939901417083,99.99125206009857
2110,A-X-L,8467697,6501381,1966316,2018.csv,2018,76.7786211528353,23.2213788471647
2111,The Outrage,8457741,44745,8412996,2010.csv,2010,0.5290419746833108,99.47095802531669
2112,Casa de mi Padre,8446952,5909483,2537469,2012.csv,2012,69.95994531518588,30.040054684814123
2113,A Street Cat Named Bob,8446262,82703,8363559,2016.csv,2016,0.9791668787920621,99.02083312120794
2114,The Way 2010 Re-release,8437872,4430765,4007107,2010.csv,2010,52.51045524274367,47.48954475725633
2115,Condorito: The Movie,8431194,447719,7983475,2017.csv,2017,5.310268035583097,94.68973196441691
2116,Raees,8428190,3262954,5165236,2017.csv,2017,38.714765566509534,61.285234433490466
2117,Malang,8399765,0,8399765,2020.csv,2020,0.0,100.0
2118,The Golden Era,8396062,102931,8293131,2014.csv,2014,1.2259437817395822,98.77405621826043
2119,Filth,8377987,34411,8343576,2013.csv,2013,0.4107311219270214,99.58926887807297
2120,Easy Money,8369756,205741,8164015,2010.csv,2010,2.4581481228365556,97.54185187716344
2121,The Love Punch,8366493,266588,8099905,2014.csv,2014,3.1863768965084893,96.81362310349151
2122,Venus in Fur,8350026,373605,7976421,2013.csv,2013,4.474297445301368,95.52570255469863
2123,I Am Not Your Negro,8345298,7123919,1221379,2017.csv,2017,85.36446511556568,14.635534884434326
2124,Khatta Meetha,8319469,541904,7777565,2010.csv,2010,6.513684947921557,93.48631505207844
2125,Time Renegades,8312361,59425,8252936,2016.csv,2016,0.7148991724493198,99.28510082755068
2126,London Boulevard,8307227,16075,8291152,2010.csv,2010,0.19350620850977107,99.80649379149023
2127,The Office,8290521,63675,8226846,2015.csv,2015,0.7680458200395367,99.23195417996047
2128,My Worst Nightmare,8226544,21952,8204592,2011.csv,2011,0.26684352505742387,99.73315647494258
2129,Cave of Forgotten Dreams,8183347,5304920,2878427,2011.csv,2011,64.82579805060203,35.17420194939797
2130,The Big Year,8179416,7204138,975278,2011.csv,2011,88.0764347968119,11.923565203188101
2131,Walk of Shame,8122990,59209,8063781,2014.csv,2014,0.728906474093899,99.2710935259061
2132,Ernest & Celestine,8111137,262075,7849062,2012.csv,2012,3.231051331027943,96.76894866897206
2133,The New Year's Eve of Old Lee,8099301,25358,8073943,2016.csv,2016,0.31308874679432214,99.68691125320568
2134,The Man Who Invented Christmas,8096007,5676486,2419521,2017.csv,2017,70.11463799376656,29.885362006233446
2135,The Company Men,8087000,4441272,3645728,2011.csv,2011,54.91865957709905,45.08134042290095
2136,Heroine,8036853,598668,7438185,2012.csv,2012,7.449035088734359,92.55096491126564
2137,My King,8003331,54114,7949217,2015.csv,2015,0.6761434707623614,99.32385652923764
2138,Disobedience,8003180,3498782,4504398,2018.csv,2018,43.71739733455951,56.282602665440486
2139,Life Itself,7997774,4102648,3895126,2018.csv,2018,51.29737349417476,48.70262650582525
2140,Denial,7994527,4073489,3921038,2016.csv,2016,50.953471043377554,49.046528956622446
2141,Metallica Through the Never,7975812,3419967,4555845,2013.csv,2013,42.879232860553884,57.120767139446116
2142,Chasing Mavericks,7942116,6002756,1939360,2012.csv,2012,75.58131863095427,24.418681369045732
2143,Suspiria,7942093,2483472,5458621,2018.csv,2018,31.269742119615067,68.73025788038493
2144,The Ark of Mr Chow,7894075,54075,7840000,2015.csv,2015,0.6850074264559178,99.31499257354407
2145,Pavarotti,7885016,4600249,3284767,2019.csv,2019,58.34165713804512,41.65834286195488
2146,The Battle of Jangsari,7883200,70853,7812347,2019.csv,2019,0.8987847574589,99.1012152425411
2147,Inside Job,7871522,4312735,3558787,2010.csv,2010,54.78908653243935,45.21091346756066
2148,For a Few Bullets,7860447,30142,7830305,2016.csv,2016,0.38346419739233656,99.61653580260766
2149,Salut d'Amour,7858183,22480,7835703,2015.csv,2015,0.28607122028082066,99.71392877971917
2150,Pele: Birth of a Legend,7846608,57046,7789562,2016.csv,2016,0.7270147814189265,99.27298521858108
2151,The Lady,7832142,355391,7476751,2011.csv,2011,4.537596483822689,95.4624035161773
2152,Renoir,7816573,2293798,5522775,2013.csv,2013,29.345315395890243,70.65468460410975
2153,Dongju: The Portrait of a Poet,7809531,56550,7752981,2016.csv,2016,0.7241151869427243,99.27588481305727
2154,Qué León,7807916,2607916,5200000,2018.csv,2018,33.40092285828894,66.59907714171105
2155,Bad Words,7804337,7779614,24723,2014.csv,2014,99.68321460234226,0.3167853976577383
2156,Amazing Grace,7796112,4450456,3345656,2018.csv,2018,57.08558317274046,42.91441682725954
2157,By the Grace of God,7755652,67059,7688593,2019.csv,2019,0.864646840781407,99.1353531592186
2158,3 idiotas,7738470,1249233,6489237,2017.csv,2017,16.143152328561072,83.85684767143893
2159,Certified Copy,7736632,1373975,6362657,2010.csv,2010,17.759342825146653,82.24065717485335
2160,Love Live! Sunshine!! The School Idol Movie: Over The Rainbow,7733048,34135,7698913,2019.csv,2019,0.4414171488396296,99.55858285116037
2161,Explosion,7731410,122700,7608710,2017.csv,2017,1.5870326369963563,98.41296736300365
2162,Cedar Rapids,7728936,6861102,867834,2011.csv,2011,88.77162393374715,11.228376066252844
2163,Spirited Away Studio Ghibli Fest 2020,7724266,0,7724266,2020.csv,2020,0.0,100.0
2164,My Mother,7723656,303002,7420654,2015.csv,2015,3.923038519581918,96.07696148041808
2165,The Sweeney,7708312,26650,7681662,2012.csv,2012,0.34573068656276496,99.65426931343724
2166,Kevin Hart: Laugh at My Pain,7706436,7706436,0,2011.csv,2011,100.0,0.0
2167,BPM (Beats Per Minute),7704369,125189,7579180,2017.csv,2017,1.624909191135575,98.37509080886443
2168,Penguins,7699452,7699452,0,2019.csv,2019,100.0,0.0
2169,No,7699095,2343664,5355431,2012.csv,2012,30.44077258431023,69.55922741568976
2170,Declaration of War,7691610,59100,7632510,2011.csv,2011,0.7683696911309856,99.23163030886901
2171,Finding Fanny,7685784,615691,7070093,2014.csv,2014,8.010776779571218,91.98922322042878
2172,Leave No Trace,7682928,6046104,1636824,2018.csv,2018,78.69530991309563,21.30469008690437
2173,Princess Mononoke Studio Ghibli Fest 2020,7673132,0,7673132,2020.csv,2020,0.0,100.0
2174,Lolo,7663798,24134,7639664,2015.csv,2015,0.31490913513117125,99.68509086486883
2175,Pandas,7635778,7574012,61766,2018.csv,2018,99.19109748869074,0.80890251130926
2176,Just Getting Started,7634022,6069605,1564417,2017.csv,2017,79.50730296559271,20.49269703440729
2177,The White Crow,7622595,1828784,5793811,2019.csv,2019,23.991619651837727,76.00838034816228
2178,Fullmetal Alchemist: The Sacred Star of Milos,7621364,177802,7443562,2011.csv,2011,2.3329419773153464,97.66705802268464
2179,ABCD (Any Body Can Dance),7610738,222098,7388640,2013.csv,2013,2.9182189690408475,97.08178103095916
2180,Only Lovers Left Alive,7609187,1879534,5729653,2013.csv,2013,24.700851746710917,75.29914825328909
2181,Klovn Forever,7585569,5700,7579869,2015.csv,2015,0.07514268211125626,99.92485731788875
2182,Burning,7576345,718991,6857354,2018.csv,2018,9.489945349637589,90.51005465036242
2183,Miss You Already,7573997,1162653,6411344,2015.csv,2015,15.350587015019942,84.64941298498006
2184,Guzaarish,7564310,1017335,6546975,2010.csv,2010,13.449144733624085,86.55085526637592
2185,Hippocrates: Diary of a French Doctor,7555591,23050,7532541,2014.csv,2014,0.3050720982647155,99.69492790173528
2186,"Kiki, Love to Love",7551282,12450,7538832,2016.csv,2016,0.1648726666544833,99.83512733334553
2187,The Advocate: A Missing Body,7550177,50162,7500015,2015.csv,2015,0.6643817754206292,99.33561822457936
2188,Take Me Home Tonight,7550073,6928068,622005,2011.csv,2011,91.76160283483352,8.238397165166482
2189,A Bigger Splash,7545758,2024099,5521659,2015.csv,2015,26.824329643224708,73.17567035677529
2190,Albert Nobbs,7532259,3014696,4517563,2011.csv,2011,40.02379631396106,59.97620368603894
2191,Beirut,7509436,5019226,2490210,2018.csv,2018,66.83892105878525,33.16107894121476
2192,Where Do We Go Now?,7507008,531997,6975011,2011.csv,2011,7.086671547439407,92.91332845256059
2193,The Whistleblower,7505141,280851,7224290,2019.csv,2019,3.7421149049698066,96.25788509503019
2194,Open Season 3,7487555,0,7487555,2010.csv,2010,0.0,100.0
2195,Frantz,7478354,880883,6597471,2016.csv,2016,11.7791027276858,88.2208972723142
2196,The Tall Man,7462847,0,7462847,2012.csv,2012,0.0,100.0
2197,Big Game,7455398,24752,7430646,2015.csv,2015,0.33200105480619546,99.6679989451938
2198,Black Nativity,7454185,7018189,435996,2013.csv,2013,94.1509903497163,5.8490096502837
2199,I'll See You in My Dreams,7452512,7449681,2831,2015.csv,2015,99.9620128085671,0.037987191432902086
2200,Yu-Gi-Oh!: The Dark Side of Dimensions,7445186,1015339,6429847,2016.csv,2016,13.637523629362652,86.36247637063735
2201,Brittany Runs a Marathon,7442106,7189808,252298,2019.csv,2019,96.60985747851481,3.3901425214851817
2202,Mayday Life,7435496,85912,7349584,2019.csv,2019,1.1554306531803662,98.84456934681964
2203,Genius,7435006,1361045,6073961,2016.csv,2016,18.30590318286226,81.69409681713773
2204,Beatriz at Dinner,7425391,7115854,309537,2017.csv,2017,95.8313710348721,4.168628965127897
2205,God's Not Dead: A Light in Darkness,7414178,5728940,1685238,2018.csv,2018,77.27006284445828,22.72993715554172
2206,Goodbye Christopher Robin,7401949,1735251,5666698,2017.csv,2017,23.44316341547341,76.5568365845266
2207,The Innocents,7400324,1065665,6334659,2016.csv,2016,14.400247881038721,85.59975211896128
2208,Return of the Hero,7362730,37108,7325622,2018.csv,2018,0.5039978377585488,99.49600216224145
2209,Compadres,7353544,3127773,4225771,2016.csv,2016,42.53422567404234,57.46577432595766
2210,Lupin III: The First,7334393,136368,7198025,2019.csv,2019,1.8592949682407256,98.14070503175928
2211,The Young Messiah,7330338,6490401,839937,2016.csv,2016,88.54163341444828,11.458366585551717
2212,Even the Rain,7313485,518017,6795468,2011.csv,2011,7.083039070976422,92.91696092902357
2213,The Beaver,7294800,970816,6323984,2011.csv,2011,13.308329220814826,86.69167077918517
2214,Let Him Go,7291152,7219300,71852,2020.csv,2020,99.01453158568083,0.9854684143191638
2215,The Midwife,7286136,603582,6682554,2017.csv,2017,8.283979327314231,91.71602067268577
2216,A Long Way Down,7257942,13347,7244595,2014.csv,2014,0.18389510414935803,99.81610489585064
2217,What We Do in the Shadows,7251226,3469224,3782002,2014.csv,2014,47.84327505445286,52.15672494554714
2218,Let There Be Light,7233471,7233471,0,2017.csv,2017,100.0,0.0
2219,Birth of the Dragon,7215027,6901965,313062,2017.csv,2017,95.660972578481,4.339027421519004
2220,20th Century Women,7214806,5664764,1550042,2016.csv,2016,78.51581872055881,21.484181279441195
2221,Animal Kingdom,7208231,1044039,6164192,2010.csv,2010,14.483983657016541,85.51601634298346
2222,Grandma,7205073,6980524,224549,2015.csv,2015,96.88345975120585,3.116540248794148
2223,Timbuktu,7179391,1076075,6103316,2014.csv,2014,14.98838829087314,85.01161170912685
2224,Blade of the Immortal,7162617,150532,7012085,2017.csv,2017,2.1016340815095935,97.8983659184904
2225,Wild Rose,7123449,1635117,5488332,2019.csv,2019,22.954007251262695,77.0459927487373
2226,Baar Baar Dekho,7122579,981947,6140632,2016.csv,2016,13.786396753198527,86.21360324680147
2227,Postman Pat: The Movie,7102455,1519,7100936,2014.csv,2014,0.021386971124773054,99.97861302887523
2228,Incendies,7099598,2071334,5028264,2011.csv,2011,29.17537021110209,70.82462978889791
2229,In Safe Hands,7086596,1737,7084859,2018.csv,2018,0.02451106285725897,99.97548893714274
2230,The Map Against the World,7035812,34034,7001778,2016.csv,2016,0.4837252615618496,99.51627473843814
2231,The Joneses,7031729,1475746,5555983,2010.csv,2010,20.98695783071276,79.01304216928725
2232,Cosmopolis,7029095,763556,6265539,2012.csv,2012,10.862792436295141,89.13720756370486
2233,The Killing of a Sacred Deer,7027336,2291901,4735435,2017.csv,2017,32.61408021474994,67.38591978525005
2234,The Kid with a Bike,7011798,1470000,5541798,2011.csv,2011,20.964665553685375,79.03533444631464
2235,Jessabelle,6998359,0,6998359,2014.csv,2014,0.0,100.0
2236,Goon,6985158,4168528,2816630,2012.csv,2012,59.67693214670305,40.32306785329695
2237,The Princess of Montpensier,6965201,352428,6612773,2010.csv,2010,5.059839622718712,94.94016037728129
2238,11-11-11,6963872,32771,6931101,2011.csv,2011,0.4705859039339034,99.52941409606609
2239,The Salesman,6953604,2402067,4551537,2016.csv,2016,34.54420182685123,65.45579817314876
2240,The Spectacular Now,6918591,6854611,63980,2013.csv,2013,99.07524523418135,0.9247547658186472
2241,Hasee Toh Phasee,6914987,646035,6268952,2014.csv,2014,9.342533832673872,90.65746616732613
2242,Don 2,6913518,3680306,3233212,2011.csv,2011,53.23347679141068,46.76652320858932
2243,Centurion,6890432,123570,6766862,2010.csv,2010,1.7933563526931258,98.20664364730688
2244,Barbara,6889185,1013902,5875283,2012.csv,2012,14.7172996515553,85.28270034844469
2245,The Awakening,6879667,209696,6669971,2011.csv,2011,3.048054506126532,96.95194549387347
2246,Talvar,6879098,342370,6536728,2015.csv,2015,4.976960642223734,95.02303935777626
2247,Antebellum,6852361,0,6852361,2020.csv,2020,0.0,100.0
2248,Dog Days,6842356,6809080,33276,2018.csv,2018,99.51367628343219,0.4863237165678021
2249,Commitment,6834802,76543,6758259,2013.csv,2013,1.1199007666937535,98.88009923330625
2250,Collide,6817535,2280004,4537531,2016.csv,2016,33.44323131454404,66.55676868545596
2251,Race 3,6817391,1690861,5126530,2018.csv,2018,24.80217138785204,75.19782861214796
2252,Bran Nue Dae,6812530,113568,6698962,2010.csv,2010,1.6670458698897475,98.33295413011025
2253,The Names of Love,6803887,514237,6289650,2010.csv,2010,7.557988543901449,92.44201145609856
2254,Baahubali: The Beginning,6787855,6738000,49855,2015.csv,2015,99.26552644392079,0.7344735560792033
2255,A Little Bit of Heaven,6778388,15375,6763013,2011.csv,2011,0.2268238407125706,99.77317615928743
2256,The Sun Is also a Star,6750029,4950029,1800000,2019.csv,2019,73.33344790074236,26.666552099257647
2257,A Letter to Momo,6748888,71712,6677176,2012.csv,2012,1.0625750494007309,98.93742495059928
2258,Midnight Special,6740647,3712282,3028365,2016.csv,2016,55.07308126356416,44.92691873643583
2259,Wild Card,6738764,0,6738764,2015.csv,2015,0.0,100.0
2260,Churchill,6724365,1281258,5443107,2017.csv,2017,19.053962716182124,80.94603728381787
2261,Cesar Chavez 2014 Re-release,6719925,5571497,1148428,2014.csv,2014,82.91010688363338,17.089893116366625
2262,Pati Patni Aur Woh,6712525,874044,5838481,2019.csv,2019,13.021091169120414,86.97890883087959
2263,Jab Tak Hai Jaan,6703114,3047539,3655575,2012.csv,2012,45.46452589050403,54.53547410949597
2264,Bleed for This,6698679,5083906,1614773,2016.csv,2016,75.89415763914049,24.105842360859505
2265,Fahrenheit 11/9,6674168,6352306,321862,2018.csv,2018,95.17749628118442,4.822503718815589
2266,Son of Saul,6659121,1777043,4882078,2015.csv,2015,26.685849378619192,73.31415062138082
2267,Fleabag,6645834,326283,6319551,2019.csv,2019,4.909586968317295,95.09041303168271
2268,The Conquest,6637166,74474,6562692,2011.csv,2011,1.1220752953896287,98.87792470461038
2269,Southside with You,6628603,6304223,324380,2016.csv,2016,95.10635951496869,4.893640485031311
2270,Pieta,6616296,22080,6594216,2012.csv,2012,0.3337214659078131,99.66627853409219
2271,The Red Turtle,6591789,921974,5669815,2016.csv,2016,13.986703761300612,86.01329623869938
2272,Soorma,6579645,390077,6189568,2018.csv,2018,5.928541737434163,94.07145826256583
2273,The Raid 2,6566916,2627209,3939707,2014.csv,2014,40.00673984561398,59.99326015438602
2274,A Melody to Remember,6559996,44263,6515733,2016.csv,2016,0.6747412650861372,99.32525873491387
2275,From the Land of the Moon,6547983,47748,6500235,2016.csv,2016,0.7292016488130773,99.27079835118691
2276,Chhapaak,6532100,604334,5927766,2020.csv,2020,9.25175670917469,90.7482432908253
2277,The Measure of a Man,6518931,112391,6406540,2015.csv,2015,1.7240710171652376,98.27592898283476
2278,The Lobster,6504366,376871,6127495,2015.csv,2015,5.794123516419587,94.20587648358041
2279,Wadjda,6499169,1347747,5151422,2012.csv,2012,20.737220404639423,79.26277959536058
2280,It's Kind of a Funny Story,6491240,6363628,127612,2010.csv,2010,98.03408901843099,1.9659109815690068
2281,Everybody Loves Somebody,6481798,1915789,4566009,2017.csv,2017,29.55644406073747,70.44355593926254
2282,Gloria,6461559,2107925,4353634,2013.csv,2013,32.622545116433976,67.37745488356602
2283,Waiting for 'Superman',6433688,6417135,16553,2010.csv,2010,99.74271366594091,0.2572863340590964
2284,Run the Race,6424420,6424420,0,2019.csv,2019,100.0,0.0
2285,Same Kind of Different as Me,6423605,6423605,0,2017.csv,2017,100.0,0.0
2286,Gotti,6412349,4343227,2069122,2018.csv,2018,67.73223041977285,32.26776958022715
2287,The Mustang,6405816,5043620,1362196,2019.csv,2019,78.73501205779249,21.26498794220752
2288,A Journey Through Time with Antony,6389648,127381,6262267,2015.csv,2015,1.9935526964865669,98.00644730351344
2289,"Farewell, My Queen",6366835,1597998,4768837,2012.csv,2012,25.098781419653566,74.90121858034644
2290,Greenberg,6344112,4234170,2109942,2010.csv,2010,66.74172839319357,33.25827160680644
2291,Hector and the Search for Happiness,6337728,1124445,5213283,2014.csv,2014,17.742083598412552,82.25791640158745
2292,Hampstead,6335171,144396,6190775,2017.csv,2017,2.2792754923268843,97.72072450767311
2293,Closed Circuit,6331939,5750401,581538,2013.csv,2013,90.81579907829182,9.184200921708184
2294,The Last Women Standing,6313827,163406,6150421,2015.csv,2015,2.588065843425865,97.41193415657413
2295,Lowriders,6312033,6303560,8473,2017.csv,2017,99.86576432664404,0.13423567335595363
2296,Absolutely Anything,6303792,20169,6283623,2015.csv,2015,0.3199502775472287,99.68004972245276
2297,A Late Quartet,6303709,1562548,4741161,2012.csv,2012,24.787755906879585,75.21224409312042
2298,My Boyfriend's Meds,6292780,2971116,3321664,2020.csv,2020,47.214680951820974,52.785319048179026
2299,Max Steel,6272403,3818664,2453739,2016.csv,2016,60.880399425865974,39.119600574134026
2300,Freaky,6218295,4372295,1846000,2020.csv,2020,70.31340584517139,29.686594154828615
2301,Norman,6217567,3814868,2402699,2017.csv,2017,61.356282931892814,38.643717068107186
2302,Unbroken: Path to Redemption,6216897,6216897,0,2018.csv,2018,100.0,0.0
2303,Attack the Block,6206022,1024175,5181847,2011.csv,2011,16.50292248400022,83.49707751599979
2304,Great Expectations,6202879,258656,5944223,2012.csv,2012,4.1699346384154845,95.83006536158452
2305,Bill & Ted Face the Music,6202513,3439660,2762853,2020.csv,2020,55.45590956439753,44.54409043560247
2306,The Snitch Cartel,6197324,0,6197324,2012.csv,2012,0.0,100.0
2307,Never Look Away,6193234,1304042,4889192,2018.csv,2018,21.05591359861423,78.94408640138577
2308,Yeh Jawaani Hai Deewani,6189998,3827466,2362532,2013.csv,2013,61.83307329016907,38.166926709830925
2309,Immortal Hero,6180032,43007,6137025,2019.csv,2019,0.6959025454884376,99.30409745451156
2310,The Autopsy of Jane Doe,6170043,10474,6159569,2016.csv,2016,0.16975570510610705,99.83024429489389
2311,Tiger & Bunny: The Rising,6168617,34471,6134146,2014.csv,2014,0.5588124534235146,99.44118754657649
2312,Darker Than Night,6160114,870063,5290051,2014.csv,2014,14.124137962381866,85.87586203761813
2313,The Patriarch,6156936,2156047,4000889,2016.csv,2016,35.01818112125902,64.98181887874098
2314,Four Lions,6148687,304616,5844071,2010.csv,2010,4.95416338480069,95.0458366151993
2315,Ploey,6146292,77815,6068477,2018.csv,2018,1.2660478870837897,98.73395211291621
2316,Mobile Suit Gundam Narrative,6126259,259224,5867035,2018.csv,2018,4.231358811307194,95.76864118869281
2317,The Duelist,6101904,13450,6088454,2016.csv,2016,0.22042300239400683,99.77957699760599
2318,The Trip to Italy,6089109,2880537,3208572,2014.csv,2014,47.30637930771152,52.69362069228848
2319,Meet the Mormons,6047363,6047363,0,2014.csv,2014,100.0,0.0
2320,She's Funny That Way,6034851,111996,5922855,2015.csv,2015,1.855820466818485,98.14417953318151
2321,Matru's Bijlee's Mandola,6009116,0,6009116,2013.csv,2013,0.0,100.0
2322,The Illusionist,6007194,2231474,3775720,2010.csv,2010,37.146694446691754,62.853305553308246
2323,Blue Exorcist: The Movie,5994921,21796,5973125,2012.csv,2012,0.36357443242371335,99.6364255675763
2324,The Broken Circle Breakdown,5990754,175058,5815696,2012.csv,2012,2.922136345441659,97.07786365455834
2325,The Rhythm Section,5989583,5437971,551612,2020.csv,2020,90.79047740051352,9.209522599486474
2326,"Cyrano, My Love",5985822,351019,5634803,2019.csv,2019,5.864173709141367,94.13582629085863
2327,Learning to Drive,5967516,3447633,2519883,2015.csv,2015,57.773334834795584,42.226665165204416
2328,The Immigrant,5952884,2025328,3927556,2013.csv,2013,34.0226350790642,65.9773649209358
2329,All Saints,5942565,5802208,140357,2017.csv,2017,97.63810745023403,2.361892549765968
2330,Death of a Nation,5885881,5885881,0,2018.csv,2018,100.0,0.0
2331,Maggie's Plan,5883891,3351735,2532156,2016.csv,2016,56.964600465916185,43.03539953408382
2332,Blue Story,5881391,0,5881391,2019.csv,2019,0.0,100.0
2333,Twiceborn,5880157,11527,5868630,2020.csv,2020,0.1960321807734045,99.80396781922659
2334,Testament of Youth,5874883,1822250,4052633,2015.csv,2015,31.017638989576472,68.98236101042353
2335,My Life as a Zucchini,5872598,309766,5562832,2016.csv,2016,5.274769361022157,94.72523063897785
2336,Tracks,5853509,510007,5343502,2014.csv,2014,8.712842160147016,91.28715783985298
2337,20 Feet from Stardom,5839368,4946445,892923,2013.csv,2013,84.7085677765128,15.2914322234872
2338,Young Goethe in Love,5826565,162138,5664427,2010.csv,2010,2.7827373418128865,97.21726265818711
2339,Puella Magi Madoka Magica the Movie Part 1: Beginnings,5816330,180440,5635890,2012.csv,2012,3.1022999038912853,96.89770009610872
2340,Phillauri,5805030,467596,5337434,2017.csv,2017,8.055014358237598,91.9449856417624
2341,Phoenix,5793245,3184472,2608773,2014.csv,2014,54.968709246717516,45.03129075328249
2342,The Wizard of Oz 2013 3D/IMAX Release,5787802,5633202,154600,2013.csv,2013,97.32886508557135,2.6711349144286554
2343,Dylan Dog: Dead of Night,5782515,1186538,4595977,2011.csv,2011,20.519410671654114,79.48058932834589
2344,The Skeleton Twins,5776640,5284309,492331,2014.csv,2014,91.47720820407712,8.522791795922888
2345,Furie,5756185,594788,5161397,2019.csv,2019,10.333024390286274,89.66697560971373
2346,The Disappointments Room,5745040,2423468,3321572,2016.csv,2016,42.183657555038785,57.81634244496122
2347,Under the Skin,5735963,2614251,3121712,2014.csv,2014,45.576496919523365,54.423503080476635
2348,The Devil's Double,5728213,1361512,4366701,2011.csv,2011,23.76852955712366,76.23147044287634
2349,Kingsglaive: Final Fantasy XV,5725482,269980,5455502,2016.csv,2016,4.715410859731984,95.28458914026801
2350,Like for Likes,5715555,50839,5664716,2016.csv,2016,0.8894849231614427,99.11051507683855
2351,Saaho,5708522,2872057,2836465,2019.csv,2019,50.31174444103045,49.68825555896956
2352,My Best Friend's Wedding,5707770,78578,5629192,2016.csv,2016,1.3766847648030667,98.62331523519693
2353,The Viral Factor,5687319,220496,5466823,2012.csv,2012,3.8769761288227373,96.12302387117725
2354,Wish I Was Here,5670776,3591299,2079477,2014.csv,2014,63.329939324000804,36.670060675999196
2355,Mission Mangal,5667057,3659413,2007644,2019.csv,2019,64.57342850089562,35.426571499104384
2356,Anomalisa,5659286,3759286,1900000,2015.csv,2015,66.42686020816053,33.57313979183946
2357,Cuban Fury,5645773,92384,5553389,2014.csv,2014,1.6363392577066063,98.36366074229339
2358,Incident in a Ghostland,5643957,0,5643957,2018.csv,2018,0.0,100.0
2359,Things to Come,5638693,388140,5250553,2016.csv,2016,6.8835100616401705,93.11648993835982
2360,Pagalpanti,5633633,423340,5210293,2019.csv,2019,7.514511506163074,92.48548849383693
2361,Wazir,5633588,1124045,4509543,2016.csv,2016,19.9525595410953,80.04744045890469
2362,Dalida,5623134,3465,5619669,2017.csv,2017,0.061620441554478336,99.93837955844552
2363,Mother and Child,5621971,1110509,4511462,2010.csv,2010,19.753019003477608,80.2469809965224
2364,Solitary Man,5615390,4360548,1254842,2010.csv,2010,77.65352005826843,22.346479941731562
2365,El Angel,5604680,109608,5495072,2018.csv,2018,1.955651348515883,98.04434865148411
2366,The Party,5597950,749827,4848123,2017.csv,2017,13.394671263587563,86.60532873641243
2367,Fathers & Daughters,5587709,0,5587709,2015.csv,2015,0.0,100.0
2368,The French Minister,5586646,12027,5574619,2013.csv,2013,0.21528122598066893,99.78471877401932
2369,Destroyer,5580940,1533324,4047616,2018.csv,2018,27.47429644468495,72.52570355531506
2370,Pawn Sacrifice,5578519,2436633,3141886,2014.csv,2014,43.67885096384901,56.321149036151
2371,Knock Knock,5567103,36336,5530767,2015.csv,2015,0.652691354911163,99.34730864508884
2372,Dheepan,5562575,261819,5300756,2014.csv,2014,4.706794964562276,95.29320503543772
2373,Escobar: Paradise Lost,5552496,195792,5356704,2014.csv,2014,3.5261979477337757,96.47380205226622
2374,Ek Tha Tiger,5543117,2347774,3195343,2012.csv,2012,42.354761770318035,57.64523822968196
2375,Last Cab to Darwin,5543036,34193,5508843,2015.csv,2015,0.6168641156218361,99.38313588437816
2376,On My Way,5505705,317324,5188381,2013.csv,2013,5.763548900640336,94.23645109935967
2377,Warriors of the Dawn,5497176,84532,5412644,2017.csv,2017,1.5377350115768533,98.46226498842314
2378,Tale of Tales,5497104,118925,5378179,2015.csv,2015,2.163411861954949,97.83658813804506
2379,Joker,5491108,169181,5321927,2012.csv,2012,3.080999317441944,96.91900068255805
2380,A Wizard's Tale,5487261,2150,5485111,2018.csv,2018,0.03918166094158816,99.9608183390584
2381,Chalet Girl,5468650,1710,5466940,2011.csv,2011,0.03126914320719008,99.9687308567928
2382,Man of Tai Chi,5464885,100144,5364741,2013.csv,2013,1.8324996774863513,98.16750032251365
2383,Thank You,5452347,463540,4988807,2011.csv,2011,8.501659927367058,91.49834007263294
2384,OK Jaanu,5445281,355922,5089359,2017.csv,2017,6.53633852871872,93.46366147128128
2385,Hara-Kiri: Death of a Samurai,5435358,75688,5359670,2011.csv,2011,1.3925117719936755,98.60748822800632
2386,An Inconvenient Sequel: Truth to Power,5433926,3496795,1937131,2017.csv,2017,64.35117077413274,35.64882922586726
2387,Hocus Pocus 2020 Re-release,5432992,4828000,604992,2020.csv,2020,88.86447835741338,11.135521642586626
2388,The Salt of the Earth,5412189,1343349,4068840,2014.csv,2014,24.820807255622448,75.17919274437756
2389,The Student and Mister Henri,5411932,761,5411171,2015.csv,2015,0.014061521837303203,99.9859384781627
2390,Lady Macbeth,5401447,1129408,4272039,2017.csv,2017,20.90936002889596,79.09063997110404
2391,Exit Through the Gift Shop,5386242,3291250,2094992,2010.csv,2010,61.10475541202939,38.89524458797061
2392,Truth,5383097,2541854,2841243,2015.csv,2015,47.219175132827814,52.780824867172186
2393,After the Storm,5382886,272132,5110754,2016.csv,2016,5.055503683340127,94.94449631665988
2394,Madame,5381950,90979,5290971,2017.csv,2017,1.6904467711517202,98.30955322884827
2395,Won't Back Down,5378228,5310554,67674,2012.csv,2012,98.74170451680368,1.2582954831963242
2396,Intruders,5348049,69136,5278913,2011.csv,2011,1.292733106970411,98.70726689302958
2397,Much Ado About Nothing,5341221,4328849,1012372,2013.csv,2013,81.0460566975229,18.953943302477093
2398,Trollhunter,5341098,253444,5087654,2010.csv,2010,4.745166630531775,95.25483336946823
2399,Sky on fire,5335450,78366,5257084,2016.csv,2016,1.4687795781049395,98.53122042189506
2400,Force,5310437,0,5310437,2011.csv,2011,0.0,100.0
2401,The Meddler 2016 Re-release,5294643,4267218,1027425,2016.csv,2016,80.595008955278,19.404991044721996
2402,Don't Let Go,5288011,5215062,72949,2019.csv,2019,98.62048320247443,1.3795167975255724
2403,Talaash,5277766,2871956,2405810,2012.csv,2012,54.416129854942405,45.58387014505759
2404,Mustang,5274664,845464,4429200,2015.csv,2015,16.028774534264173,83.97122546573583
2405,True Story,5261595,4719695,541900,2015.csv,2015,89.70084166493241,10.299158335067599
2406,Les Misérables: The Staged Concert,5257431,459478,4797953,2019.csv,2019,8.739591637056197,91.2604083629438
2407,The Truth,5252668,9619,5243049,2019.csv,2019,0.18312598473766095,99.81687401526233
2408,The Biggest Little Farm,5248412,4366949,881463,2019.csv,2019,83.20514852873593,16.794851471264067
2409,Tucker and Dale vs Evil,5224938,223838,5001100,2010.csv,2010,4.284031695687107,95.7159683043129
2410,Kill the Messenger,5218973,2450846,2768127,2014.csv,2014,46.96031192343781,53.039688076562186
2411,The New Girlfriend,5215796,146754,5069042,2014.csv,2014,2.813645318950358,97.18635468104965
2412,Mountains May Depart,5210160,82913,5127247,2015.csv,2015,1.5913714741965697,98.40862852580344
2413,Zindagi Na Milegi Dobara,5192743,3108485,2084258,2011.csv,2011,59.86209985743566,40.13790014256434
2414,Oldboy,5186767,2193658,2993109,2013.csv,2013,42.2933592351459,57.7066407648541
2415,MI-5,5161464,0,5161464,2015.csv,2015,0.0,100.0
2416,October Baby 2012 Re-release,5157886,5157886,0,2012.csv,2012,100.0,0.0
2417,Rabbit Hole,5140925,2229058,2911867,2010.csv,2010,43.3590842114989,56.640915788501104
2418,The Legend of Chupacabras,5138140,0,5138140,2016.csv,2016,0.0,100.0
2419,In the Fade,5104991,321011,4783980,2017.csv,2017,6.288179548210761,93.71182045178924
2420,"Good Day, Ramon",5104868,154356,4950512,2014.csv,2014,3.0237020820126985,96.9762979179873
2421,Action Point,5103663,5059608,44055,2018.csv,2018,99.13679645384109,0.8632035461589058
2422,Serena,5092129,176391,4915738,2014.csv,2014,3.463993154925965,96.53600684507403
2423,Dark Places,5090852,208588,4882264,2014.csv,2014,4.097310234121911,95.9026897658781
2424,Locke,5090608,1375769,3714839,2014.csv,2014,27.02563230168184,72.97436769831816
2425,The Liberator,5082098,113067,4969031,2014.csv,2014,2.2248095176440907,97.77519048235591
2426,The Sense of an Ending,5081495,1274420,3807075,2017.csv,2017,25.07962715696857,74.92037284303143
2427,Dogman,5080147,148225,4931922,2018.csv,2018,2.9177305302385936,97.0822694697614
2428,Anthropoid,5079219,2964845,2114374,2016.csv,2016,58.3720646815977,41.6279353184023
2429,Konosuba!: God's Blessing on This Wonderful World! - Legend of Crimson,5078942,1134786,3944156,2019.csv,2019,22.34296040395815,77.65703959604186
2430,Doctor Who: The Day of the Doctor,5074950,0,5074950,2013.csv,2013,0.0,100.0
2431,Stand Up Guys,5072654,3310031,1762623,2013.csv,2013,65.2524497038434,34.74755029615661
2432,Mr. X,5061387,44995,5016392,2015.csv,2015,0.8889855685803121,99.11101443141969
2433,Monsters,5060438,237301,4823137,2010.csv,2010,4.689337168047509,95.31066283195248
2434,Table 19,5042014,3614896,1427118,2017.csv,2017,71.69547724381566,28.304522756184337
2435,Kedi,5037923,2835047,2202876,2017.csv,2017,56.2741232845361,43.72587671546389
2436,The Real Exorcist,5035830,0,5035830,2020.csv,2020,0.0,100.0
2437,Breathe,5026154,490131,4536023,2017.csv,2017,9.751611271759678,90.24838872824033
2438,Oranges and Sunshine,5017653,143480,4874173,2011.csv,2011,2.8595042343502035,97.14049576564979
2439,Double Lover,5012423,167581,4844842,2017.csv,2017,3.3433132040133087,96.65668679598669
2440,Worlds Apart,5011560,60298,4951262,2015.csv,2015,1.2031782518816496,98.79682174811835
2441,Blindspotting,5006989,4333394,673595,2018.csv,2018,86.54690473655924,13.453095263440762
2442,Hands of Stone,4978353,4712792,265561,2016.csv,2016,94.66568561932029,5.334314380679714
2443,Take This Waltz,4965950,1239692,3726258,2012.csv,2012,24.963843776115347,75.03615622388466
2444,The Professor and the Madman,4957273,0,4957273,2019.csv,2019,0.0,100.0
2445,Swiss Army Man,4935501,4210454,725047,2016.csv,2016,85.30955621323955,14.69044378676045
2446,Nymphomaniac: Vol. II,4934725,327167,4607558,2014.csv,2014,6.629893256463126,93.37010674353688
2447,Sgt. Stubby: An American Hero,4932694,4015935,916759,2018.csv,2018,81.41463873493876,18.58536126506124
2448,Slack Bay,4925446,112621,4812825,2016.csv,2016,2.2865137492117467,97.71348625078825
2449,Desierto,4924990,2002036,2922954,2016.csv,2016,40.65055969656791,59.34944030343209
2450,[REC] 4: Apocalypse,4915757,837,4914920,2014.csv,2014,0.017026879074779327,99.98297312092522
2451,Panga,4886124,582720,4303404,2020.csv,2020,11.92601743222235,88.07398256777765
2452,Samson,4873825,4719928,153897,2018.csv,2018,96.84237739352561,3.1576226064743813
2453,The Young Karl Marx,4870373,125659,4744714,2017.csv,2017,2.580069329392225,97.41993067060778
2454,Back To The Future Day,4850000,1650000,3200000,2015.csv,2015,34.02061855670103,65.97938144329896
2455,90 Minutes in Heaven,4842699,4842699,0,2015.csv,2015,100.0,0.0
2456,RamLeela,4840059,2738863,2101196,2013.csv,2013,56.5873887074517,43.41261129254829
2457,Jimmy's Hall,4825184,560592,4264592,2014.csv,2014,11.618043995835185,88.38195600416482
2458,Predestination,4824499,68372,4756127,2014.csv,2014,1.4171834215324741,98.58281657846753
2459,Capital,4822849,101700,4721149,2012.csv,2012,2.1087120911311965,97.8912879088688
2460,Mazinger Z: INFINITY,4812371,220682,4591689,2017.csv,2017,4.585722921196226,95.41427707880378
2461,The SpongeBob Movie: Sponge on the Run,4810790,4810790,0,2020.csv,2020,100.0,0.0
2462,Trash,4809022,17484,4791538,2014.csv,2014,0.363566646191263,99.63643335380874
2463,Robot & Frank,4806423,3325038,1481385,2012.csv,2012,69.17905477732609,30.820945222673913
2464,Burke and Hare,4791599,4833,4786766,2010.csv,2010,0.10086403307121486,99.89913596692878
2465,A Royal Night Out,4779170,228136,4551034,2015.csv,2015,4.7735485450402475,95.22645145495974
2466,Martha Marcy May Marlene,4778439,2990625,1787814,2011.csv,2011,62.58581515846493,37.41418484153507
2467,Gladiator 20th Anniversary,4777216,0,4777216,2020.csv,2020,0.0,100.0
2468,Men & Chicken,4765472,30207,4735265,2015.csv,2015,0.633872153692226,99.36612784630778
2469,The Broken Hearts Gallery,4753131,4067442,685689,2020.csv,2020,85.57395114925299,14.426048850747014
2470,The Double,4729855,137921,4591934,2011.csv,2011,2.915966768537302,97.0840332314627
2471,Clouds of Sils Maria,4728401,1851517,2876884,2014.csv,2014,39.15735996164454,60.842640038355455
2472,Sweet Bean,4720010,124800,4595210,2015.csv,2015,2.6440621947834857,97.35593780521651
2473,Girl in Progress,4709246,2609412,2099834,2012.csv,2012,55.410399032031876,44.58960096796812
2474,"Jeff, Who Lives at Home",4704757,4269426,435331,2012.csv,2012,90.74700351155225,9.252996488447756
2475,Unlocked,4699125,0,4699125,2017.csv,2017,0.0,100.0
2476,Menteur,4697364,4697364,0,2019.csv,2019,100.0,0.0
2477,Jay and Silent Bob Reboot,4691248,4589490,101758,2019.csv,2019,97.83089702356388,2.169102976436121
2478,Keith Lemon: The Film,4682943,0,4682943,2012.csv,2012,0.0,100.0
2479,The Runaways,4681651,3573673,1107978,2010.csv,2010,76.33360538835552,23.66639461164448
2480,Warriors of the Rainbow: Seediq Bale I,4670432,136166,4534266,2011.csv,2011,2.9154904728299225,97.08450952717008
2481,Where to Invade Next,4664756,3827261,837495,2016.csv,2016,82.0463278250781,17.953672174921902
2482,A Simple Life,4663094,191826,4471268,2012.csv,2012,4.113706479002997,95.886293520997
2483,Tubelight,4650456,930058,3720398,2017.csv,2017,19.999286091514467,80.00071390848554
2484,Gemma Bovery,4644525,191533,4452992,2014.csv,2014,4.123844741927323,95.87615525807269
2485,Everybody Wants Some!!,4644472,3400278,1244194,2016.csv,2016,73.21129290907557,26.788707090924436
2486,Housefull 4,4634173,2109160,2525013,2019.csv,2019,45.51319081096023,54.486809189039775
2487,Dear White People,4633961,4404154,229807,2014.csv,2014,95.04080850054629,4.959191499453707
2488,Killer Joe,4633668,1987762,2645906,2012.csv,2012,42.8982395803929,57.1017604196071
2489,Hamlet 2018 Re-release,4630718,235229,4395489,2018.csv,2018,5.0797522112121705,94.92024778878783
2490,Atlas Shrugged: Part I,4627375,4627375,0,2011.csv,2011,100.0,0.0
2491,Heneral Luna,4625639,206040,4419599,2015.csv,2015,4.454303502716058,95.54569649728394
2492,Bad Samaritan,4623836,3435047,1188789,2018.csv,2018,74.2899834682718,25.710016531728204
2493,The Last Black Man in San Francisco,4607017,4515719,91298,2019.csv,2019,98.01828384831227,1.9817161516877406
2494,A Hidden Life,4605404,1730597,2874807,2019.csv,2019,37.57752848610024,62.42247151389976
2495,Whitney,4605123,3026351,1578772,2018.csv,2018,65.71705033720055,34.28294966279945
2496,The Guilty,4598051,207140,4390911,2018.csv,2018,4.5049522069241945,95.4950477930758
2497,The Book of Henry,4596705,4504974,91731,2017.csv,2017,98.00441838229776,1.9955816177022454
2498,Labyrinth of Lies,4574756,794452,3780304,2014.csv,2014,17.365997224770023,82.63400277522997
2499,Find a Boyfriend for My Wife... PLEASE!,4570757,1741889,2828868,2016.csv,2016,38.10942038703873,61.890579612961275
2500,The Beach Bum,4554416,3502600,1051816,2019.csv,2019,76.9055791126678,23.094420887332205
2501,The Iceman,4552970,1969193,2583777,2013.csv,2013,43.2507352343635,56.7492647656365
2502,Colossal,4531320,3029287,1502033,2017.csv,2017,66.85219759363717,33.14780240636283
2503,Cezanne et Moi,4529583,257597,4271986,2016.csv,2016,5.6869914956851435,94.31300850431485
2504,"Juliet, Naked",4511157,3444895,1066262,2018.csv,2018,76.36389068258985,23.636109317410146
2505,Maps to the Stars,4510934,350741,4160193,2014.csv,2014,7.775352066778188,92.22464793322182
2506,Simon and the Oaks,4505573,150664,4354909,2011.csv,2011,3.343947595566646,96.65605240443335
2507,Barfi!,4490134,2804874,1685260,2012.csv,2012,62.46748983437911,37.53251016562089
2508,Rundskop,4483147,151840,4331307,2011.csv,2011,3.3869065636259528,96.61309343637404
2509,Woman at War,4481653,847495,3634158,2018.csv,2018,18.9103217049602,81.0896782950398
2510,The Wall,4476705,1803064,2673641,2017.csv,2017,40.27658735610231,59.72341264389769
2511,Batman: The Killing Joke,4462034,3775000,687034,2016.csv,2016,84.60267223423219,15.397327765767809
2512,Flypaper,4453634,5043,4448591,2011.csv,2011,0.11323337301628288,99.88676662698371
2513,Buck,4448728,4038912,409816,2011.csv,2011,90.78801850776222,9.211981492237781
2514,In Harm's Way,4447734,0,4447734,2017.csv,2017,0.0,100.0
2515,Mental,4446852,17669,4429183,2012.csv,2012,0.39733726240495526,99.60266273759505
2516,Leviathan,4439481,1092800,3346681,2014.csv,2014,24.615489963804325,75.38451003619568
2517,Swift,4428275,0,4428275,2019.csv,2019,0.0,100.0
2518,Samsara,4426444,2672413,1754031,2012.csv,2012,60.37381247791681,39.62618752208319
2519,Safety Not Guaranteed,4424699,4010957,413742,2012.csv,2012,90.6492622436012,9.350737756398797
2520,Don't Think Twice,4417667,4417667,0,2016.csv,2016,100.0,0.0
2521,The Commune,4410339,38737,4371602,2016.csv,2016,0.8783225053675012,99.1216774946325
2522,Thérèse,4408087,101944,4306143,2012.csv,2012,2.312658529652432,97.68734147034756
2523,The Eagle Huntress,4400140,3169351,1230789,2016.csv,2016,72.02841273232215,27.971587267677844
2524,360,4396975,100343,4296632,2012.csv,2012,2.282091665292616,97.71790833470739
2525,Kabali,4388789,3903095,485694,2016.csv,2016,88.93330255794936,11.066697442050643
2526,White Elephant,4387907,8884,4379023,2012.csv,2012,0.20246554906473632,99.79753445093526
2527,Clown,4381603,55007,4326596,2014.csv,2014,1.2554081234653163,98.74459187653468
2528,Brian Banks,4376819,4376819,0,2019.csv,2019,100.0,0.0
2529,Seven Days in Utopia,4373074,4373074,0,2011.csv,2011,100.0,0.0
2530,There Be Dragons,4372642,1069334,3303308,2011.csv,2011,24.455100600506512,75.54489939949349
2531,Mark Felt: The Man Who Brought Down the White House,4372130,768946,3603184,2017.csv,2017,17.587445935962563,82.41255406403744
2532,Demolition,4366460,1978592,2387868,2016.csv,2016,45.31341177979416,54.68658822020585
2533,King of Devil's Island,4360391,7615,4352776,2010.csv,2010,0.17464030175275566,99.82535969824724
2534,Blinky Bill the Movie,4344536,0,4344536,2015.csv,2015,0.0,100.0
2535,Storm Boy,4324268,71760,4252508,2018.csv,2018,1.6594716146177806,98.34052838538221
2536,Standing Tall,4323120,26144,4296976,2015.csv,2015,0.6047484224356483,99.39525157756435
2537,The Wretched,4314507,1814193,2500314,2020.csv,2020,42.04867439084002,57.95132560915997
2538,Please Give,4313829,4033574,280255,2010.csv,2010,93.5033354358738,6.496664564126209
2539,Tezz,4305016,229931,4075085,2012.csv,2012,5.341002216948787,94.65899778305122
2540,The Grand Seduction,4292517,3430018,862499,2014.csv,2014,79.90691708384614,20.093082916153858
2541,High-Rise,4286576,346472,3940104,2016.csv,2016,8.082721500796906,91.91727849920309
2542,The Other Side of Hope,4282973,183943,4099030,2017.csv,2017,4.294750398846783,95.70524960115321
2543,Linda Ronstadt: The Sound of My Voice,4252657,4252657,0,2019.csv,2019,100.0,0.0
2544,"Don't Worry, He Won't Get Far on Foot",4241656,1441705,2799951,2018.csv,2018,33.989201387382664,66.01079861261734
2545,Branded,4227984,353513,3874471,2012.csv,2012,8.361266267800445,91.63873373219955
2546,Military Wives,4217455,0,4217455,2020.csv,2020,0.0,100.0
2547,Dabangg 2,4216988,2519190,1697798,2012.csv,2012,59.73908391487004,40.260916085129956
2548,No Escape,4215955,167962,4047993,2020.csv,2020,3.9839609293742457,96.01603907062575
2549,The Rabbi's Cat,4208573,23392,4185181,2011.csv,2011,0.5558178508487319,99.44418214915127
2550,Diplomacy,4207242,230880,3976362,2014.csv,2014,5.487680528003856,94.51231947199614
2551,Let the Sunshine In,4192590,892421,3300169,2017.csv,2017,21.28567305651161,78.71432694348839
2552,Sheep & Wolves,4190750,0,4190750,2016.csv,2016,0.0,100.0
2553,Song of the Sea,4190670,857522,3333148,2014.csv,2014,20.462646784404402,79.5373532155956
2554,Tanu Weds Manu Returns,4180081,3043479,1136602,2015.csv,2015,72.80909149846619,27.190908501533823
2555,Nitro Circus: The Movie,4174269,3377618,796651,2012.csv,2012,80.91519736749116,19.08480263250883
2556,Krrish 3,4170204,2191534,1978670,2013.csv,2013,52.55220128319862,47.44779871680139
2557,The Guardians,4167608,177331,3990277,2017.csv,2017,4.254982714305184,95.74501728569481
2558,A Quiet Passion,4159246,1865396,2293850,2016.csv,2016,44.849378949934675,55.15062105006533
2559,Savage,4140502,74491,4066011,2019.csv,2019,1.7990813674283939,98.20091863257161
2560,The Last Princess,4135255,29259,4105996,2016.csv,2016,0.7075500785320373,99.29244992146796
2561,Ghost Stories,4131358,148747,3982611,2018.csv,2018,3.600438403062625,96.39956159693737
2562,Apartment 143,4126744,383,4126361,2012.csv,2012,0.009280924622414184,99.99071907537758
2563,Arctic 2019 Re-release,4124015,2410795,1713220,2019.csv,2019,58.45747408775186,41.54252591224814
2564,Carancho,4120012,85526,4034486,2010.csv,2010,2.075867740191048,97.92413225980894
2565,The Fall of the American Empire,4110928,2178460,1932468,2018.csv,2018,52.991927856678586,47.008072143321414
2566,Naam Hai Akira,4108063,219401,3888662,2016.csv,2016,5.3407408795824205,94.65925912041759
2567,The Hero,4101699,4077333,24366,2017.csv,2017,99.40595348415377,0.5940465158462384
2568,Force Majeure,4094339,1359497,2734842,2014.csv,2014,33.20430965779824,66.79569034220175
2569,2001: A Space Odyssey 2018 Re-release,4084582,3236321,848261,2018.csv,2018,79.23261180703436,20.767388192965644
2570,Tere Naal Love Ho Gaya,4083976,177743,3906233,2012.csv,2012,4.352204812173236,95.64779518782677
2571,American Animals,4080073,2856954,1223119,2018.csv,2018,70.0221295060162,29.97787049398381
2572,Katti Batti,4079135,364932,3714203,2015.csv,2015,8.94630846981039,91.05369153018961
2573,From Prada to Nada,4058694,3033623,1025071,2011.csv,2011,74.74382153471043,25.256178465289576
2574,Two Days in New York,4058113,633210,3424903,2012.csv,2012,15.603557614093052,84.39644238590695
2575,Infidel,4051136,4051136,0,2020.csv,2020,100.0,0.0
2576,The Killer Inside Me,4050140,217277,3832863,2010.csv,2010,5.364678751845616,94.63532124815438
2577,Film Stars Don't Die in Liverpool,4047917,1026124,3021793,2017.csv,2017,25.349432807046192,74.65056719295382
2578,Love in the Buff,4045381,256451,3788930,2012.csv,2012,6.339353450268343,93.66064654973165
2579,Junglee,4033587,295784,3737803,2019.csv,2019,7.333026410487737,92.66697358951225
2580,Rare Exports,4028971,236347,3792624,2010.csv,2010,5.866187669258478,94.13381233074152
2581,Vulgaria,4028543,59059,3969484,2012.csv,2012,1.4660138913746235,98.53398610862537
2582,Jeepers Creepers III,4017852,2335162,1682690,2017.csv,2017,58.11966194872284,41.88033805127715
2583,A Perfect Day,4009440,14044,3995396,2015.csv,2015,0.35027335488247735,99.64972664511752
2584,Penguin Highway,4006647,104567,3902080,2018.csv,2018,2.6098381015347742,97.39016189846522
2585,Faces Places,3996577,953717,3042860,2017.csv,2017,23.863346058389467,76.13665394161053
2586,Ride Your Wave,3995885,332432,3663453,2019.csv,2019,8.319358540098126,91.68064145990188
2587,Sleight,3989705,3986245,3460,2017.csv,2017,99.91327679615411,0.08672320384589838
2588,The Invisible Woman,3986888,1234254,2752634,2013.csv,2013,30.95782976597286,69.04217023402714
2589,The Nile Hilton Incident,3979536,81089,3898447,2017.csv,2017,2.037649615432553,97.96235038456744
2590,Ip Man: The Final Fight,3967001,37884,3929117,2013.csv,2013,0.9549783324985298,99.04502166750146
2591,Lucifer,3956978,0,3956978,2019.csv,2019,0.0,100.0
2592,Break Ke Baad,3954699,427628,3527071,2010.csv,2010,10.813161760224988,89.18683823977501
2593,The Devil's Violinist,3952097,11294,3940803,2013.csv,2013,0.2857723380777344,99.71422766192227
2594,Bully 2012 Re-release,3950244,3863446,86798,2012.csv,2012,97.8027180093179,2.1972819906820944
2595,2:22,3945729,422,3945307,2017.csv,2017,0.010695108559153454,99.98930489144084
2596,Terminator 2: Judgment Day 2017 Re-release,3931111,1037809,2893302,2017.csv,2017,26.39989051441183,73.60010948558818
2597,Welcome to the Punch,3926386,9747,3916639,2013.csv,2013,0.24824355017565772,99.75175644982434
2598,Loveless,3925992,566356,3359636,2017.csv,2017,14.425806267562441,85.57419373243756
2599,Seven Sins Forgiven,3924850,270207,3654643,2011.csv,2011,6.884517879664191,93.11548212033581
2600,Indignation,3924527,3401155,523372,2016.csv,2016,86.664074422217,13.335925577783003
2601,100% Wolf,3917529,421216,3496313,2020.csv,2020,10.752083775257312,89.24791622474268
2602,A Private War,3915207,1633208,2281999,2018.csv,2018,41.71447384518877,58.28552615481123
2603,The To Do List,3909596,3491669,417927,2013.csv,2013,89.31022540436403,10.689774595635969
2604,The Starving Games,3906308,0,3906308,2013.csv,2013,0.0,100.0
2605,Taxi,3906227,321642,3584585,2015.csv,2015,8.234083682284721,91.76591631771528
2606,The Wall,3889260,38674,3850586,2012.csv,2012,0.994379393509305,99.0056206064907
2607,Rules Don't Apply,3885342,3652206,233136,2016.csv,2016,93.99960157947486,6.000398420525143
2608,Neruda,3884746,939101,2945645,2016.csv,2016,24.17406440472556,75.82593559527444
2609,The Perfect Game,3878993,1037071,2841922,2010.csv,2010,26.735572866463027,73.26442713353698
2610,"The Night Is Short, Walk on Girl",3878208,406490,3471718,2017.csv,2017,10.481387279898344,89.51861272010166
2611,Django,3876874,56556,3820318,2017.csv,2017,1.4588041808941945,98.54119581910581
2612,Horns,3875442,173948,3701494,2014.csv,2014,4.488468670154268,95.51153132984574
2613,Submarine,3875173,467602,3407571,2011.csv,2011,12.06660967136177,87.93339032863823
2614,First Reformed,3862498,3448256,414242,2018.csv,2018,89.27528247263817,10.724717527361827
2615,Frozen,3843774,246176,3597598,2010.csv,2010,6.404538872472731,93.59546112752727
2616,Marley,3842919,1413480,2429439,2012.csv,2012,36.781415377217165,63.218584622782835
2617,To Save a Life,3824868,3777210,47658,2010.csv,2010,98.75399621634001,1.2460037836599853
2618,Elles,3822241,157508,3664733,2012.csv,2012,4.120828592440927,95.87917140755907
2619,The Other Son,3820405,1285918,2534487,2012.csv,2012,33.65920628833854,66.34079371166146
2620,The Homesman,3819421,2429989,1389432,2014.csv,2014,63.62192070473509,36.37807929526491
2621,Brad's Status,3816527,2133158,1683369,2017.csv,2017,55.8926479493005,44.1073520506995
2622,Sweet 20,3810429,71775,3738654,2015.csv,2015,1.8836461721239262,98.11635382787607
2623,Custody,3790303,83882,3706421,2018.csv,2018,2.2130684538940555,97.78693154610595
2624,The Paperboy,3783865,693286,3090579,2012.csv,2012,18.322165299237682,81.67783470076232
2625,Citizenfour,3780692,2800870,979822,2014.csv,2014,74.08352756585302,25.916472434146975
2626,Green Room,3769214,3220371,548843,2016.csv,2016,85.43879440116693,14.561205598833071
2627,Black Sea,3758103,1171559,2586544,2014.csv,2014,31.17421209583665,68.82578790416335
2628,The Trip,3741198,2030962,1710236,2011.csv,2011,54.2864077228738,45.7135922771262
2629,Take Shelter,3741098,1730296,2010802,2011.csv,2011,46.25102042234659,53.74897957765341
2630,Like Crazy,3731489,3395391,336098,2011.csv,2011,90.99292534427946,9.007074655720544
2631,Ragnarok,3721345,1369,3719976,2013.csv,2013,0.03678777431278207,99.96321222568722
2632,Free Fire,3719383,1799312,1920071,2017.csv,2017,48.37662590811433,51.623374091885665
2633,Summertime,3719031,35322,3683709,2015.csv,2015,0.9497635271123043,99.0502364728877
2634,Night of 7 Years,3716820,24281,3692539,2018.csv,2018,0.6532734972368853,99.34672650276312
2635,The Last King,3705618,8905,3696713,2016.csv,2016,0.24031079296354887,99.75968920703644
2636,A Fantastic Woman,3702353,2020988,1681365,2017.csv,2017,54.58658318102029,45.41341681897971
2637,Spare Parts,3701281,3618912,82369,2015.csv,2015,97.77458128685717,2.225418713142828
2638,Western Stars,3681681,1581681,2100000,2019.csv,2019,42.96083772602787,57.03916227397213
2639,1911,3680151,135739,3544412,2011.csv,2011,3.688408437588566,96.31159156241144
2640,Gosnell: The Trial of America's Biggest Serial Killer,3679893,3679893,0,2018.csv,2018,100.0,0.0
2641,5 Flights Up,3679847,1020921,2658926,2015.csv,2015,27.74357194742064,72.25642805257935
2642,Love Crime,3663918,539792,3124126,2010.csv,2010,14.73264412576919,85.26735587423082
2643,Number One Fan,3650598,15549,3635049,2014.csv,2014,0.4259302174602627,99.57406978253974
2644,Non-Fiction,3649042,704919,2944123,2018.csv,2018,19.317919607392845,80.68208039260716
2645,A la mala,3646627,3629842,16785,2015.csv,2015,99.53971162940438,0.46028837059562167
2646,Celeste & Jesse Forever,3640975,3094813,546162,2012.csv,2012,84.99956742356099,15.000432576439005
2647,The German Doctor,3635718,418392,3217326,2013.csv,2013,11.507823214011648,88.49217678598835
2648,Karthik Calling Karthik,3627172,286409,3340763,2010.csv,2010,7.8962067417812,92.1037932582188
2649,Crooked House,3625952,0,3625952,2017.csv,2017,0.0,100.0
2650,Colonia,3621046,15709,3605337,2016.csv,2016,0.43382492241192183,99.56617507758808
2651,The Last Circus,3604598,40548,3564050,2010.csv,2010,1.1248965904103592,98.87510340958964
2652,The Insult,3601603,1001305,2600298,2017.csv,2017,27.80164832159458,72.19835167840543
2653,Phoenix Forgotten,3600146,3600146,0,2017.csv,2017,100.0,0.0
2654,Heart Blackened,3593480,37047,3556433,2017.csv,2017,1.0309504992375078,98.9690495007625
2655,Badla,3590894,1861000,1729894,2019.csv,2019,51.82553425414396,48.17446574585604
2656,Indivisible,3589633,3511417,78216,2018.csv,2018,97.82105858732633,2.1789414126736633
2657,Ghostbusters 30th Anniversary Release,3580343,3580343,0,2014.csv,2014,100.0,0.0
2658,The Apparition,3562793,28293,3534500,2018.csv,2018,0.7941241604550138,99.20587583954499
2659,Bacurau,3541476,58115,3483361,2019.csv,2019,1.6409824604204575,98.35901753957954
2660,The Oscar Nominated Short Films 2019: Documentary,3538550,3531094,7456,2019.csv,2019,99.78929222421613,0.21070777578386626
2661,Catfish,3533711,3237343,296368,2010.csv,2010,91.61312286149037,8.386877138509629
2662,Ek Ladki Ko Dekha Toh Aisa Laga,3531837,1182636,2349201,2019.csv,2019,33.48501077484606,66.51498922515393
2663,The Riot Club,3517925,7734,3510191,2014.csv,2014,0.21984550551816767,99.78015449448183
2664,The Oscar Nominated Short Films 2018: Live Action,3511123,3508777,2346,2018.csv,2018,99.93318377054862,0.06681622945137496
2665,Ladrones,3504414,3063505,440909,2015.csv,2015,87.41846711033571,12.581532889664294
2666,Thanks for Sharing,3499442,1065881,2433561,2013.csv,2013,30.458598828041726,69.54140117195827
2667,Faustina: Love and Mercy,3498887,2243180,1255707,2019.csv,2019,64.11124451861406,35.888755481385935
2668,The Empty Man,3497994,2940461,557533,2020.csv,2020,84.06135059122457,15.93864940877543
2669,Maiden,3495241,3168978,326263,2019.csv,2019,90.66550775754804,9.334492242451951
2670,Wild Target,3494154,108589,3385565,2010.csv,2010,3.1077336602794268,96.89226633972058
2671,Racetime,3493043,1875283,1617760,2018.csv,2018,53.686227166399036,46.31377283360096
2672,Veronica Mars,3485383,3322127,163256,2014.csv,2014,95.31598105574051,4.684018944259497
2673,The Aeronauts,3485251,0,3485251,2019.csv,2019,0.0,100.0
2674,3,3484446,59954,3424492,2010.csv,2010,1.7206178543160089,98.279382145684
2675,Jack and the Cuckoo-Clock Heart,3484370,0,3484370,2014.csv,2014,0.0,100.0
2676,Miles Ahead,3473958,2610896,863062,2016.csv,2016,75.15623389804944,24.84376610195057
2677,Great Performances at the Met: Puccini: Tosca,3473616,2023749,1449867,2018.csv,2018,58.26058493512236,41.73941506487764
2678,Hors la loi,3470487,96933,3373554,2010.csv,2010,2.7930662180840904,97.20693378191591
2679,Enemy,3468224,1008726,2459498,2014.csv,2014,29.08479959771918,70.91520040228082
2680,Til Death Do Us Part,3455267,3455267,0,2017.csv,2017,100.0,0.0
2681,Obsession,3454709,528799,2925910,2016.csv,2016,15.30661482631388,84.69338517368612
2682,Words and Pictures,3438874,2171257,1267617,2014.csv,2014,63.138602926423005,36.86139707357699
2683,A Gentleman,3438746,410055,3028691,2017.csv,2017,11.924550402966663,88.07544959703334
2684,The Rider,3434963,2419031,1015932,2018.csv,2018,70.42378622418931,29.576213775810682
2685,He Named Me Malala,3433606,2668936,764670,2015.csv,2015,77.72982689335934,22.270173106640655
2686,Borg vs. McEnroe,3430165,231346,3198819,2017.csv,2017,6.744456899303677,93.25554310069633
2687,Disconnect,3428048,1436900,1991148,2013.csv,2013,41.91598250666269,58.08401749333731
2688,Special Forces,3424648,10759,3413889,2011.csv,2011,0.31416367463167016,99.68583632536833
2689,Next Time I'll Aim for the Heart,3418213,815,3417398,2014.csv,2014,0.023842867603627978,99.97615713239637
2690,Midnight Diner,3412771,18555,3394216,2019.csv,2019,0.5436930869372718,99.45630691306273
2691,Friends 25th: The One With The Anniversary,3403406,2884827,518579,2019.csv,2019,84.76294041909782,15.23705958090219
2692,Honey Boy,3400977,3012615,388362,2019.csv,2019,88.58086955601287,11.419130443987125
2693,The Protector 2,3399790,2463,3397327,2013.csv,2013,0.0724456510549181,99.92755434894508
2694,The Good Lie,3396345,2722209,674136,2014.csv,2014,80.15113305627078,19.848866943729217
2695,Rock the Kasbah,3394174,3020664,373510,2015.csv,2015,88.9955553250953,11.004444674904704
2696,"All's Well, Ends Well 2012",3392158,47919,3344239,2012.csv,2012,1.412640566860388,98.58735943313961
2697,Gauguin: Voyage to Tahiti,3389322,200140,3189182,2017.csv,2017,5.905015811421872,94.09498418857812
2698,Anything for Alice,3387582,1092,3386490,2014.csv,2014,0.03223538205126843,99.96776461794873
2699,Apartment 1303 3D,3377891,0,3377891,2012.csv,2012,0.0,100.0
2700,The Neon Demon,3377430,1333124,2044306,2016.csv,2016,39.471550853755666,60.528449146244334
2701,The King's Speech PG-13 Version,3375215,3344306,30909,2011.csv,2011,99.08423611532895,0.9157638846710506
2702,The Hole in the Ground,3373474,21072,3352402,2019.csv,2019,0.6246379844634937,99.37536201553651
2703,Patrick the Pug,3369468,6290,3363178,2018.csv,2018,0.18667635365582935,99.81332364634416
2704,The Last Full Measure,3364426,2949212,415214,2020.csv,2020,87.6586972042185,12.341302795781509
2705,Echo in the Canyon,3355324,3355324,0,2019.csv,2019,100.0,0.0
2706,Reality,3350996,72577,3278419,2012.csv,2012,2.1658336804937997,97.8341663195062
2707,Panipat,3349899,461863,2888036,2019.csv,2019,13.787370902824234,86.21262909717576
2708,Mistress America,3340737,2500431,840306,2015.csv,2015,74.84668802123603,25.153311978763966
2709,Machine Gun Preacher,3338690,538690,2800000,2011.csv,2011,16.134771422324327,83.86522857767568
2710,Atlas Shrugged II: The Strike,3336053,3336053,0,2012.csv,2012,100.0,0.0
2711,On Chesil Beach,3335913,745971,2589942,2018.csv,2018,22.3618241842638,77.6381758157362
2712,The Program,3335613,13074,3322539,2015.csv,2015,0.3919519440654536,99.60804805593455
2713,By the Sea,3334927,538460,2796467,2015.csv,2015,16.146080558884798,83.8539194411152
2714,Raiders of the Lost Ark 2012 IMAX Release,3332854,3125613,207241,2012.csv,2012,93.78187583374489,6.218124166255108
2715,Last Ounce of Courage,3329674,3329674,0,2012.csv,2012,100.0,0.0
2716,Vanishing Time: A Boy Who Returned,3328517,57759,3270758,2016.csv,2016,1.7352773021739112,98.26472269782609
2717,The Death & Life of John F. Donovan,3326364,152713,3173651,2019.csv,2019,4.590988839465555,95.40901116053445
2718,Obvious Child,3325417,3123963,201454,2014.csv,2014,93.94199283879286,6.058007161207151
2719,Flying Swords of Dragon Gate,3323381,170276,3153105,2011.csv,2011,5.123577465237961,94.87642253476204
2720,Breath,3322479,37108,3285371,2018.csv,2018,1.116876886204548,98.88312311379546
2721,Wildlife,3321367,1050616,2270751,2018.csv,2018,31.632035845481692,68.3679641545183
2722,The Rental,3317792,1637548,1680244,2020.csv,2020,49.35656002546272,50.64343997453729
2723,Chhichhore,3311391,2004400,1306991,2019.csv,2019,60.53045381835005,39.469546181649946
2724,2020 Oscar Nominated Short Films,3306611,3306611,0,2020.csv,2020,100.0,0.0
2725,Heist,3294317,50136,3244181,2015.csv,2015,1.5218936125454836,98.47810638745452
2726,Wonderstruck,3285916,1060377,2225539,2017.csv,2017,32.27036235862389,67.7296376413761
2727,Good Time,3283369,2026499,1256870,2017.csv,2017,61.720111263765965,38.27988873623403
2728,Bharath Ane Nenu,3276257,2663090,613167,2018.csv,2018,81.28452682436085,18.715473175639154
2729,Marianne & Leonard: Words of Love,3273573,1012034,2261539,2019.csv,2019,30.915272089548633,69.08472791045136
2730,Samsam,3272825,53273,3219552,2020.csv,2020,1.6277375050606127,98.37226249493939
2731,Chicken with Plums,3265941,253874,3012067,2011.csv,2011,7.7733798620367,92.2266201379633
2732,Bilal: A New Breed of Hero,3254027,0,3254027,2016.csv,2016,0.0,100.0
2733,Your Sister's Sister,3242802,1636190,1606612,2012.csv,2012,50.456056213114465,49.54394378688554
2734,In Harmony,3242445,3144,3239301,2015.csv,2015,0.09696386523133006,99.90303613476867
2735,The Front Runner,3242235,2000105,1242130,2018.csv,2018,61.689081759958796,38.31091824004121
2736,Sleeping with Other People,3224947,819431,2405516,2015.csv,2015,25.409130754706975,74.59086924529302
2737,Love is in the Air 2013 Re-release,3221554,8425,3213129,2013.csv,2013,0.2615197510269889,99.73848024897302
2738,Embrace of the Serpent,3217176,1329249,1887927,2015.csv,2015,41.31726085237488,58.68273914762512
2739,The Mystery of Happiness,3216374,8528,3207846,2014.csv,2014,0.26514329490289373,99.7348567050971
2740,Ava,3207103,497747,2709356,2020.csv,2020,15.520143880629963,84.47985611937003
2741,6 Souls,3205167,0,3205167,2010.csv,2010,0.0,100.0
2742,Saint Laurent,3202241,429477,2772764,2014.csv,2014,13.411763824146902,86.5882361758531
2743,I,3200113,1449232,1750881,2015.csv,2015,45.28690080631528,54.71309919368472
2744,Dear Zindagi,3199581,2376479,823102,2016.csv,2016,74.27469409275777,25.72530590724223
2745,Fill the Void,3197615,1775316,1422299,2012.csv,2012,55.52000475354287,44.47999524645713
2746,Victoria,3191971,0,3191971,2015.csv,2015,0.0,100.0
2747,Empire of Lust,3191168,10654,3180514,2015.csv,2015,0.3338589507039429,99.66614104929606
2748,Thoroughbreds,3187255,3072605,114650,2018.csv,2018,96.40286076890617,3.5971392310938413
2749,Showtime Championship Boxing: Floyd Mayweather vs. Conor McGregor,3184384,2620183,564201,2017.csv,2017,82.2822561600611,17.7177438399389
2750,Tea With the Dames,3181152,889343,2291809,2018.csv,2018,27.95663332025631,72.0433666797437
2751,Pastorela,3179022,161194,3017828,2011.csv,2011,5.070553144960935,94.92944685503907
2752,Pilgrim's Progress,3173282,1294596,1878686,2019.csv,2019,40.796752384439834,59.20324761556017
2753,Rosewater,3171593,3128941,42652,2014.csv,2014,98.65518684143899,1.3448131585610135
2754,Land of Mine,3169553,435266,2734287,2015.csv,2015,13.732725087733192,86.26727491226681
2755,The Lodge,3155858,2138907,1016951,2020.csv,2020,67.77576811123947,32.22423188876052
2756,Ingrid Goes West,3146831,3024308,122523,2017.csv,2017,96.10646393149172,3.8935360685082867
2757,The Secret: Dare to Dream,3134693,0,3134693,2020.csv,2020,0.0,100.0
2758,The Deep Blue Sea,3115609,1126525,1989084,2011.csv,2011,36.15745749867843,63.842542501321574
2759,In a World...,3114953,2963902,151051,2013.csv,2013,95.15077755587323,4.849222444126766
2760,Close Encounters of the Third Kind 2017 Re-release,3101507,3100479,1028,2017.csv,2017,99.96685482251047,0.03314517748952364
2761,Come Undone,3101465,10035,3091430,2010.csv,2010,0.3235567707518866,99.67644322924811
2762,Raw,3096815,514870,2581945,2017.csv,2017,16.625791337228733,83.37420866277127
2763,Star Wars: Episode V - The Empire Strikes Back 2020 Re-release,3096080,2482000,614080,2020.csv,2020,80.16588718637762,19.834112813622387
2764,Aquarius,3085977,285930,2800047,2016.csv,2016,9.265461148932737,90.73453885106726
2765,The People Vs. Fritz Bauer,3083973,288483,2795490,2015.csv,2015,9.354264774691607,90.64573522530839
2766,Mumbai Diaries,3082958,576639,2506319,2011.csv,2011,18.70408224828233,81.29591775171767
2767,3 Hearts,3077754,161129,2916625,2014.csv,2014,5.2352787129835585,94.76472128701644
2768,Ismael's Ghosts,3075562,102510,2973052,2017.csv,2017,3.333049374390762,96.66695062560923
2769,Living Is Easy with Eyes Closed,3075169,11600,3063569,2013.csv,2013,0.3772150408644208,99.62278495913559
2770,The End of the Tour,3072991,3002884,70107,2015.csv,2015,97.71860705091554,2.281392949084459
2771,Jane Got a Gun,3067531,1513793,1553738,2015.csv,2015,49.34890633542089,50.65109366457911
2772,'71,3062178,1270847,1791331,2014.csv,2014,41.50140847462166,58.49859152537834
2773,Remember,3054936,547009,2507927,2015.csv,2015,17.90574336090838,82.09425663909163
2774,Starred Up,3025189,54915,2970274,2014.csv,2014,1.8152584846764945,98.18474151532351
2775,The Greatest Miracle,3019382,555166,2464216,2011.csv,2011,18.386742717549485,81.61325728245052
2776,All Is True,3019143,1200481,1818662,2019.csv,2019,39.76231003301268,60.23768996698732
2777,Top Gun 2013 3D Release,3018873,3018873,0,2013.csv,2013,100.0,0.0
2778,Rigor Mortis,3016904,7865,3009039,2013.csv,2013,0.26069772190298396,99.73930227809701
2779,The Second Mother,3003560,376986,2626574,2015.csv,2015,12.55130578380322,87.44869421619677
2780,The Imposter,3001877,898317,2103560,2012.csv,2012,29.92517681437314,70.07482318562685
2781,Made for More,2999134,2999134,0,2018.csv,2018,100.0,0.0
2782,The Last Word,2982004,1783421,1198583,2017.csv,2017,59.80612366717148,40.19387633282852
2783,Memoir of War,2980982,103636,2877346,2018.csv,2018,3.4765724851743487,96.52342751482566
2784,Love Is Strange 2014 Re-release,2979739,2262223,717516,2014.csv,2014,75.9201728742014,24.0798271257986
2785,Romeo and Juliet,2966268,1162635,1803633,2013.csv,2013,39.19521095194366,60.80478904805634
2786,The Last: Naruto the Movie,2949185,524451,2424734,2015.csv,2015,17.782912906447034,82.21708709355296
2787,Sibyl,2943278,0,2943278,2019.csv,2019,0.0,100.0
2788,Fearless,2942554,1288549,1654005,2010.csv,2010,43.79015644232867,56.20984355767133
2789,Filly Brown,2940411,2850357,90054,2013.csv,2013,96.93736691911437,3.062633080885631
2790,Joan Rivers: A Piece of Work,2930687,2930687,0,2010.csv,2010,100.0,0.0
2791,Brighton Rock,2913599,229653,2683946,2011.csv,2011,7.882107318131287,92.11789268186872
2792,The House That Jack Built,2911800,87993,2823807,2018.csv,2018,3.021945188543169,96.97805481145683
2793,Letters to God,2908893,2848578,60315,2010.csv,2010,97.92653081429947,2.0734691857005396
2794,Children of the Sea,2892603,0,2892603,2019.csv,2019,0.0,100.0
2795,The East,2891812,2301839,589973,2013.csv,2013,79.59850087073434,20.401499129265666
2796,The Oscar Nominated Short Films 2017: Live Action,2877797,2835355,42442,2017.csv,2017,98.52519131822015,1.4748086817798476
2797,Maria By Callas,2869237,1267301,1601936,2017.csv,2017,44.16857164465675,55.83142835534325
2798,Starbuck,2865068,340058,2525010,2011.csv,2011,11.869107469700545,88.13089253029945
2799,Home Run,2861020,2861020,0,2013.csv,2013,100.0,0.0
2800,The Flowers of War,2855644,311434,2544210,2012.csv,2012,10.905911241037048,89.09408875896295
2801,Inhumans,2852282,1521787,1330495,2017.csv,2017,53.35331499480065,46.646685005199345
2802,The Salt of Life,2850852,317405,2533447,2011.csv,2011,11.13368915678541,88.86631084321459
2803,The Oscar Nominated Short Films 2016: Live Action,2850840,2816816,34024,2016.csv,2016,98.806527199001,1.1934728009990039
2804,God Bless the Broken Road,2848233,2846257,1976,2018.csv,2018,99.93062365333174,0.06937634666826765
2805,Remember You,2845124,14814,2830310,2016.csv,2016,0.5206802937235776,99.47931970627643
2806,A Breath Away,2842040,77987,2764053,2018.csv,2018,2.7440500485566703,97.25594995144333
2807,The Identical,2840991,2827666,13325,2014.csv,2014,99.5309735229714,0.46902647702861433
2808,Personal Shopper,2840408,1305195,1535213,2016.csv,2016,45.95096901571887,54.04903098428113
2809,The Fluffy Movie: Unity Through Laughter,2827393,2827393,0,2014.csv,2014,100.0,0.0
2810,A Coffee in Berlin,2826333,150275,2676058,2012.csv,2012,5.316960174190373,94.68303982580963
2811,Everything Must Go,2820490,2711643,108847,2011.csv,2011,96.14084786686001,3.859152133139986
2812,The Informer,2814653,187405,2627248,2019.csv,2019,6.658191968956742,93.34180803104326
2813,Captive,2801508,2583301,218207,2015.csv,2015,92.21108774274427,7.788912257255736
2814,To the Wonder,2801166,587615,2213551,2013.csv,2013,20.977514363661417,79.02248563633859
2815,"Cinco de Mayo, La Batalla",2794852,173472,2621380,2013.csv,2013,6.206840290648664,93.79315970935134
2816,After the Wedding,2790019,1574258,1215761,2019.csv,2019,56.42463366736929,43.57536633263071
2817,Kirk Cameron's Saving Christmas,2783970,2783970,0,2014.csv,2014,100.0,0.0
2818,Kinky Boots the Musical,2780537,900451,1880086,2019.csv,2019,32.38406825731864,67.61593174268135
2819,The Wonders,2772358,73378,2698980,2014.csv,2014,2.6467721701165576,97.35322782988344
2820,Battle for Incheon: Operation Chromite,2749918,1023348,1726570,2016.csv,2016,37.213764192241364,62.78623580775863
2821,McQueen,2739246,1257275,1481971,2018.csv,2018,45.89857939009494,54.10142060990506
2822,Edie,2731170,71790,2659380,2018.csv,2018,2.6285438108942323,97.37145618910577
2823,Lucky,2728446,955925,1772521,2017.csv,2017,35.035511056476835,64.96448894352315
2824,Cocktail,2724695,1227789,1496906,2012.csv,2012,45.061520647265105,54.938479352734895
2825,Chi-Raq,2719699,2653032,66667,2015.csv,2015,97.54873609175134,2.45126390824867
2826,Billionaire Boys Club,2713955,1349,2712606,2018.csv,2018,0.04970605629054277,99.95029394370945
2827,What Maisie Knew,2711379,1066471,1644908,2013.csv,2013,39.33315851454186,60.666841485458136
2828,The Guest,2700051,332890,2367161,2014.csv,2014,12.329026377649905,87.6709736223501
2829,Gangsterdam,2697522,954,2696568,2017.csv,2017,0.03536579127065507,99.96463420872934
2830,Jiro Dreams of Sushi,2692864,2552478,140386,2012.csv,2012,94.78674006559558,5.213259934404411
2831,A Hijacking,2688444,414437,2274007,2012.csv,2012,15.415496845015184,84.58450315498482
2832,The Cup,2660645,0,2660645,2011.csv,2011,0.0,100.0
2833,Diego Maradona,2656890,0,2656890,2019.csv,2019,0.0,100.0
2834,Hillsong: Let Hope Rise,2649761,2394386,255375,2016.csv,2016,90.36233833919361,9.63766166080639
2835,Twelve,2648195,183920,2464275,2010.csv,2010,6.945107894244948,93.05489210575504
2836,Pioneer,2647820,6871,2640949,2013.csv,2013,0.2594964914533465,99.74050350854665
2837,Stories We Tell,2641053,1600145,1040908,2013.csv,2013,60.587386924836416,39.412613075163584
2838,The Weasel's Tale,2640752,0,2640752,2019.csv,2019,0.0,100.0
2839,Beautiful Accident,2632092,51766,2580326,2017.csv,2017,1.9667245673783438,98.03327543262166
2840,Maniac,2631275,31081,2600194,2012.csv,2012,1.1812144302666958,98.81878556973331
2841,Third Person,2624761,1021398,1603363,2014.csv,2014,38.91394302185989,61.0860569781401
2842,The Happy Prince,2621992,466440,2155552,2018.csv,2018,17.78952796194649,82.21047203805351
2843,The Little Mermaid,2613377,147175,2466202,2018.csv,2018,5.631602329093735,94.36839767090626
2844,Happy End,2610794,301718,2309076,2017.csv,2017,11.556560954253763,88.44343904574625
2845,Poster Boys,2602256,97049,2505207,2017.csv,2017,3.729417858965452,96.27058214103454
2846,N-Secure,2595644,2595644,0,2010.csv,2010,100.0,0.0
2847,The Signal,2595622,600896,1994726,2014.csv,2014,23.150366270589476,76.84963372941053
2848,Leo Da Vinci: Mission Mona Lisa,2588859,19978,2568881,2018.csv,2018,0.7716913126593608,99.22830868734064
2849,A Question of Faith,2587072,2587072,0,2017.csv,2017,100.0,0.0
2850,Blancanieves,2585522,279735,2305787,2012.csv,2012,10.819285235244566,89.18071476475544
2851,Assassination Nation,2584988,2005142,579846,2018.csv,2018,77.56871598630245,22.43128401369755
2852,Metallica & San Francisco Symphony - S&M2,2582847,1252385,1330462,2019.csv,2019,48.48854771498273,51.51145228501727
2853,The Gatekeepers,2573616,2415727,157889,2013.csv,2013,93.86509098482446,6.134909015175535
2854,Is Genesis History?,2570392,2570392,0,2017.csv,2017,100.0,0.0
2855,Maquia: When the Promised Flower Blooms 2018 Re-release,2569927,18539,2551388,2018.csv,2018,0.721382358331579,99.27861764166842
2856,Blood Ties,2566435,42472,2523963,2013.csv,2013,1.6549026178336874,98.34509738216632
2857,Waves,2563470,1658790,904680,2019.csv,2019,64.70877365446056,35.29122634553944
2858,God's Own Country,2559939,335609,2224330,2017.csv,2017,13.11003895014686,86.88996104985314
2859,The Only Living Boy in New York,2550321,624332,1925989,2017.csv,2017,24.48052617690087,75.51947382309913
2860,"1,000 Times Good Night",2549568,53895,2495673,2013.csv,2013,2.1138875291814143,97.88611247081859
2861,Words on Bathroom Walls,2545934,2542436,3498,2020.csv,2020,99.86260445086165,0.13739554913835159
2862,Disney's Newsies: The Broadway Musical!,2545060,2545060,0,2017.csv,2017,100.0,0.0
2863,The Dinner,2544921,1323312,1221609,2017.csv,2017,51.99815632783886,48.00184367216114
2864,El Jeremías,2540144,650465,1889679,2016.csv,2016,25.607406509237272,74.39259349076272
2865,In the Name of My Daughter,2537899,277528,2260371,2014.csv,2014,10.935344550748473,89.06465544925153
2866,IN OUR HANDS: Battle for Jerusalem,2534370,2534370,0,2017.csv,2017,100.0,0.0
2867,Poetry,2533089,356149,2176940,2010.csv,2010,14.059869195278965,85.94013080472104
2868,Spirits in the Forest,2531785,704744,1827041,2019.csv,2019,27.835854940289163,72.16414505971083
2869,Bucky Larson: Born to Be a Star,2530394,2529395,999,2011.csv,2011,99.96051998226363,0.03948001773636833
2870,Ittefaq,2520487,298032,2222455,2017.csv,2017,11.824381558008433,88.17561844199156
2871,Restless,2518012,163265,2354747,2011.csv,2011,6.483884906029042,93.51611509397095
2872,Birds of Passage,2517405,507259,2010146,2018.csv,2018,20.15007517662037,79.84992482337962
2873,LBJ,2510151,2470979,39172,2017.csv,2017,98.43945643110713,1.5605435688928673
2874,The Rover,2510007,1114423,1395584,2014.csv,2014,44.39919888669633,55.60080111330367
2875,Grace Unplugged,2507201,2507201,0,2013.csv,2013,100.0,0.0
2876,I'm in Love with a Church Girl,2503392,2387730,115662,2013.csv,2013,95.37978870268819,4.6202112973118075
2877,The Queen of Versailles,2495706,2401999,93707,2012.csv,2012,96.24527087725878,3.7547291227412205
2878,Still Life,2495025,9481,2485544,2013.csv,2013,0.37999619242292165,99.62000380757708
2879,"One Nation, One King",2481681,6576,2475105,2018.csv,2018,0.2649816797565843,99.73501832024341
2880,Cairo Time,2477315,1603616,873699,2010.csv,2010,64.73201833436603,35.26798166563396
2881,The Christmas Candle,2476775,2258620,218155,2013.csv,2013,91.19197343319438,8.808026566805625
2882,Painted Skin: The Resurrection,2455359,50425,2404934,2012.csv,2012,2.0536711739505304,97.94632882604947
2883,Piku,2452343,1801807,650536,2015.csv,2015,73.47287879387181,26.52712120612818
2884,Footnote,2451259,2007758,443501,2011.csv,2011,81.9072158429607,18.0927841570393
2885,The Tree,2450045,71158,2378887,2010.csv,2010,2.904354817972731,97.09564518202727
2886,Love at First Fight,2446362,25229,2421133,2014.csv,2014,1.031286457196441,98.96871354280356
2887,Lean on Pete,2443584,1163056,1280528,2018.csv,2018,47.59631754013777,52.40368245986223
2888,Coriolanus,2435325,757195,1678130,2012.csv,2012,31.092154024616836,68.90784597538317
2889,The Unknown Girl,2432640,150549,2282091,2016.csv,2016,6.188708563535911,93.81129143646409
2890,Joe,2431443,373375,2058068,2014.csv,2014,15.356107463757118,84.64389253624289
2891,The Grace Card,2430735,2430735,0,2011.csv,2011,100.0,0.0
2892,The Breadwinner 2018 Re-release,2426907,834,2426073,2018.csv,2018,0.03436472843829615,99.96563527156171
2893,Life of Riley,2423379,11616,2411763,2014.csv,2014,0.4793307196274293,99.52066928037257
2894,After.Life,2422634,108595,2314039,2010.csv,2010,4.4825177884897185,95.51748221151028
2895,Hearts Beat Loud,2417165,2386251,30914,2018.csv,2018,98.72106372548005,1.278936274519944
2896,The Art of Self-Defense,2414269,2410914,3355,2019.csv,2019,99.86103454089002,0.13896545910998317
2897,Rodin,2413672,44261,2369411,2017.csv,2017,1.8337620024593233,98.16623799754068
2898,The Oscar Nominated Short Films 2015: Live Action,2412593,2412593,0,2015.csv,2015,100.0,0.0
2899,Beloved Sisters,2407680,54030,2353650,2014.csv,2014,2.2440689792663475,97.75593102073366
2900,Sound! Euphonium the Movie - Our Promise: A Brand New Day,2403030,90341,2312689,2019.csv,2019,3.7594620125424987,96.2405379874575
2901,The Stroller Strategy,2401291,3462,2397829,2013.csv,2013,0.14417244723775668,99.85582755276225
2902,The Man Who Killed Don Quixote,2390383,391963,1998420,2018.csv,2018,16.39749780683681,83.60250219316319
2903,Twilight/New Moon,2385237,2385237,0,2010.csv,2010,100.0,0.0
2904,Finding Vivian Maier,2384584,1514782,869802,2014.csv,2014,63.52395218620942,36.47604781379058
2905,Laggies,2379154,1066981,1312173,2014.csv,2014,44.84707589336377,55.15292410663623
2906,I Wish,2371548,145808,2225740,2011.csv,2011,6.148220487209198,93.8517795127908
2907,Lore,2362019,970325,1391694,2012.csv,2012,41.08032153848043,58.919678461519574
2908,Cake,2360281,1951776,408505,2015.csv,2015,82.69252686438607,17.30747313561394
2909,Desi Boyz,2355293,1078826,1276467,2011.csv,2011,45.80432243461854,54.19567756538146
2910,Chico & Rita,2347919,350524,1997395,2010.csv,2010,14.929135119226855,85.07086488077314
2911,Memories of the Sword,2345062,111071,2233991,2015.csv,2015,4.73637797209626,95.26362202790374
2912,Terraferma,2343302,19996,2323306,2011.csv,2011,0.8533257770445295,99.14667422295547
2913,The Nightmare Before Christmas 2020 Re-release,2342526,2286000,56526,2020.csv,2020,97.58696381598327,2.413036184016741
2914,1991,2342264,2342264,0,2018.csv,2018,100.0,0.0
2915,Housefull,2340550,1183658,1156892,2010.csv,2010,50.57178868214736,49.42821131785264
2916,Ong-bak 3,2340516,14890,2325626,2010.csv,2010,0.6361844994864381,99.36381550051357
2917,Meru,2334228,2334228,0,2015.csv,2015,100.0,0.0
2918,Jem and the Holograms,2333684,2184640,149044,2015.csv,2015,93.61335982078121,6.38664017921878
2919,Bhaag Milkha Bhaag,2325917,1636731,689186,2013.csv,2013,70.36927800949046,29.63072199050955
2920,The Oranges,2316971,366377,1950594,2012.csv,2012,15.8127572593701,84.1872427406299
2921,Austenland,2313509,2159041,154468,2013.csv,2013,93.32321594599374,6.676784054006274
2922,A Aa,2313043,2313043,0,2016.csv,2016,100.0,0.0
2923,WARx2,2310625,2310625,0,2015.csv,2015,100.0,0.0
2924,The Resurrection of Gavin Stone,2308355,2303792,4563,2017.csv,2017,99.80232676516394,0.19767323483606292
2925,Blackfish,2303417,2073582,229835,2013.csv,2013,90.0219977537719,9.978002246228105
2926,Piranhas,2298525,23494,2275031,2019.csv,2019,1.0221337596937168,98.97786624030628
2927,The Remaining,2297261,1169603,1127658,2014.csv,2014,50.91293501260849,49.08706498739151
2928,3 from Hell,2295825,2172949,122876,2019.csv,2019,94.64784990145155,5.352150098548452
2929,Ek Main Aur Ekk Tu,2293823,1155545,1138278,2012.csv,2012,50.37638039203548,49.62361960796452
2930,Rock on 2,2293659,98868,2194791,2016.csv,2016,4.310492536161652,95.68950746383835
2931,Going Away,2290889,19501,2271388,2014.csv,2014,0.8512415922377732,99.14875840776223
2932,American Honey,2290649,663246,1627403,2016.csv,2016,28.954501540829696,71.0454984591703
2933,RV: Resurrected Victims,2269892,20374,2249518,2017.csv,2017,0.8975757436917704,99.10242425630823
2934,Luce,2268204,2010613,257591,2019.csv,2019,88.64339362773366,11.35660637226634
2935,Sleepwalk with Me,2266067,2266067,0,2012.csv,2012,100.0,0.0
2936,Puzzle,2260946,2032018,228928,2018.csv,2018,89.87468077521534,10.12531922478467
2937,Shadow Dancer,2253819,100616,2153203,2012.csv,2012,4.4642449105274205,95.53575508947259
2938,An Interview with God,2251795,1201434,1050361,2018.csv,2018,53.35450163092111,46.645498369078894
2939,Marius,2249781,9781,2240000,2013.csv,2013,0.43475342711135,99.56524657288865
2940,My All-American,2246000,2246000,0,2015.csv,2015,100.0,0.0
2941,No culpes al karma de lo que te pasa por gilipollas,2242471,5614,2236857,2016.csv,2016,0.25034883394255714,99.74965116605745
2942,Relic,2237347,1047083,1190264,2020.csv,2020,46.8002057794343,53.1997942205657
2943,At War,2235052,4605,2230447,2018.csv,2018,0.2060354747898483,99.79396452521016
2944,Elena,2227905,233380,1994525,2011.csv,2011,10.475312008366606,89.5246879916334
2945,Delhi Safari,2225597,0,2225597,2012.csv,2012,0.0,100.0
2946,Heal the Living,2223529,3176,2220353,2016.csv,2016,0.14283600528709092,99.8571639947129
2947,The Lovers,2216083,2194521,21562,2017.csv,2017,99.02702200233475,0.97297799766525
2948,Bill Cunningham: New York,2210382,1510026,700356,2011.csv,2011,68.3151600040174,31.684839995982593
2949,Elliot the Littlest Reindeer,2195706,24262,2171444,2018.csv,2018,1.10497489190265,98.89502510809734
2950,Goodnight Mommy,2193474,1178196,1015278,2015.csv,2015,53.713697996876185,46.286302003123815
2951,3 Faces,2191516,72324,2119192,2018.csv,2018,3.3001812443988547,96.69981875560114
2952,What Will People Say,2191131,44156,2146975,2017.csv,2017,2.0152149734543485,97.98478502654565
2953,Anchorman 2: The Legend Continues R-Rated Extended Cut,2185255,2184339,916,2014.csv,2014,99.95808269515457,0.04191730484542994
2954,Made in Italy,2180161,101339,2078822,2020.csv,2020,4.648234694593656,95.35176530540635
2955,Border,2177678,771930,1405748,2018.csv,2018,35.44738937528872,64.55261062471126
2956,The King of Staten Island,2176478,0,2176478,2020.csv,2020,0.0,100.0
2957,Gone with the Wind 2019 Re-release,2176120,2176120,0,2019.csv,2019,100.0,0.0
2958,Veere Di Wedding,2176099,0,2176099,2018.csv,2018,0.0,100.0
2959,The Oscar Nominated Short Films 2014: Live Action,2171849,2171849,0,2014.csv,2014,100.0,0.0
2960,Henry's Crime,2169799,102541,2067258,2011.csv,2011,4.725829443188056,95.27417055681194
2961,The Reluctant Fundamentalist,2167020,552959,1614061,2013.csv,2013,25.517023377726094,74.48297662227391
2962,The Benefactor,2159380,0,2159380,2015.csv,2015,0.0,100.0
2963,The High Note,2149814,0,2149814,2020.csv,2020,0.0,100.0
2964,The Saratov Approach,2146999,2146999,0,2013.csv,2013,100.0,0.0
2965,The Oscar Nominated Short Films 2013: Live Action,2142342,2142342,0,2013.csv,2013,100.0,0.0
2966,Let Yourself Go,2140190,12189,2128001,2017.csv,2017,0.56952887360468,99.43047112639533
2967,The Attack,2139516,1720325,419191,2013.csv,2013,80.407204246194,19.592795753806
2968,High Life,2133033,1225852,907181,2018.csv,2018,57.469903184807734,42.530096815192266
2969,My Scientology Movie,2130866,22936,2107930,2016.csv,2016,1.0763698890498041,98.9236301109502
2970,Mountain,2129889,365412,1764477,2017.csv,2017,17.156387022985705,82.84361297701429
2971,Heleno,2126384,0,2126384,2012.csv,2012,0.0,100.0
2972,Sightseers,2122909,61782,2061127,2012.csv,2012,2.910251923186533,97.08974807681346
2973,Jai Ho,2122804,1264515,858289,2014.csv,2014,59.5681466588531,40.4318533411469
2974,Abracadabra,2114260,13975,2100285,2017.csv,2017,0.6609877687701607,99.33901223122984
2975,"20,000 Days on Earth",2105558,279558,1826000,2014.csv,2014,13.277145535767716,86.72285446423228
2976,The Eye of the Storm,2104689,83566,2021123,2011.csv,2011,3.970467845843258,96.02953215415674
2977,Once Upon a Time in Anatolia,2099472,152408,1947064,2011.csv,2011,7.259349017276724,92.74065098272327
2978,The Wizard of Oz 2019 Re-release,2097514,2076020,21494,2019.csv,2019,98.97526309717122,1.0247369028287772
2979,Indian Horse,2097362,2097362,0,2018.csv,2018,100.0,0.0
2980,Mary Shelley,2096600,108900,1987700,2018.csv,2018,5.194123819517314,94.80587618048268
2981,The Captive,2090612,1075178,1015434,2014.csv,2014,51.42886389248699,48.57113610751301
2982,"The Butcher, the Chef, and the Swordsman",2089266,47896,2041370,2011.csv,2011,2.292479751261926,97.70752024873808
2983,Lost in Paris,2087225,691597,1395628,2017.csv,2017,33.134760267819715,66.8652397321803
2984,Girl Most Likely,2085617,1378591,707026,2013.csv,2013,66.09991192054918,33.90008807945083
2985,Equals,2084628,33258,2051370,2016.csv,2016,1.595392559247981,98.40460744075202
2986,High Strung,2084451,53447,2031004,2016.csv,2016,2.5640804221351328,97.43591957786487
2987,I'm Not Ashamed,2082980,2082980,0,2016.csv,2016,100.0,0.0
2988,A Cat in Paris,2080634,309973,1770661,2010.csv,2010,14.89800704977425,85.10199295022575
2989,Wi-heom-han gyan-gye,2074864,54000,2020864,2012.csv,2012,2.602580217305809,97.3974197826942
2990,Black '47,2073063,57520,2015543,2018.csv,2018,2.7746383009102953,97.2253616990897
2991,A Fool,2067820,8212,2059608,2015.csv,2015,0.39713321275546226,99.60286678724454
2992,Hotchpotch 3,2067671,1132192,935479,2010.csv,2010,54.75687379665334,45.24312620334666
2993,American Pastoral,2063436,544098,1519338,2016.csv,2016,26.3685425668642,73.6314574331358
2994,Hotchpotch Again,2057329,1013893,1043436,2017.csv,2017,49.282005940712445,50.717994059287555
2995,Under the Silver Lake,2053469,46083,2007386,2018.csv,2018,2.2441536736127987,97.7558463263872
2996,Being 17,2045219,52713,1992506,2016.csv,2016,2.5773767992571943,97.4226232007428
2997,W.E.,2042203,583455,1458748,2012.csv,2012,28.56988262185493,71.43011737814507
2998,Raid,2031135,1010385,1020750,2018.csv,2018,49.744847092881564,50.255152907118436
2999,Climax,2027391,817339,1210052,2018.csv,2018,40.31481840454062,59.68518159545939
3000,42nd Street: The Musical,2022093,187440,1834653,2019.csv,2019,9.269603326849953,90.73039667315005
3001,Armadillo,2018685,14566,2004119,2010.csv,2010,0.7215588365693508,99.27844116343066
3002,Graduation,2015002,175975,1839027,2016.csv,2016,8.73324195211717,91.26675804788283
3003,The Outpost,2011660,0,2011660,2020.csv,2020,0.0,100.0
3004,Little Men,2008649,702537,1306112,2016.csv,2016,34.97559802633511,65.0244019736649
3005,Greater,2000093,2000093,0,2016.csv,2016,100.0,0.0
3006,Peterloo,1998945,151971,1846974,2018.csv,2018,7.602560350584933,92.39743964941508
3007,1898: Our Last Men in the Philippines,1995045,2848,1992197,2016.csv,2016,0.1427536722229323,99.85724632777708
3008,Antboy,1994566,0,1994566,2013.csv,2013,0.0,100.0
3009,The Trip to Spain,1988841,1157604,831237,2017.csv,2017,58.20495454387756,41.79504545612244
3010,Summer 1993,1983149,185903,1797246,2017.csv,2017,9.37413174703464,90.62586825296536
3011,Great Performances at the Met: Verdi: La Traviata,1982588,1882931,99657,2018.csv,2018,94.97338831870262,5.026611681297375
3012,Singham Returns,1974745,1232018,742727,2014.csv,2014,62.38871347946191,37.611286520538094
3013,Beloved,1971858,137515,1834343,2011.csv,2011,6.973879457851427,93.02612054214858
3014,Diary of a Chambermaid,1971247,54235,1917012,2015.csv,2015,2.7513041237348745,97.24869587626512
3015,Maquia: When the Promised Flower Blooms,1963575,185699,1777876,2018.csv,2018,9.457189055676508,90.54281094432349
3016,Menashe,1962265,1703036,259229,2017.csv,2017,86.78929706232339,13.210702937676613
3017,Holy Motors,1954125,641100,1313025,2012.csv,2012,32.80752254845519,67.1924774515448
3018,A Ghost Story,1951683,1596371,355312,2017.csv,2017,81.79458446889171,18.20541553110828
3019,Deadfall,1946254,66351,1879903,2012.csv,2012,3.4091644769901563,96.59083552300984
3020,Marie Curie: The Courage of Knowledge,1944392,127986,1816406,2017.csv,2017,6.582314677287296,93.41768532271271
3021,V/H/S,1944287,100345,1843942,2012.csv,2012,5.16101789499184,94.83898210500816
3022,Housefull 3,1944262,1326999,617263,2016.csv,2016,68.25206685107254,31.74793314892746
3023,Another Earth,1938783,1321194,617589,2011.csv,2011,68.14553253252168,31.854467467478308
3024,Luka Chuppi,1923586,1042905,880681,2019.csv,2019,54.21670775312359,45.78329224687641
3025,Jane,1921221,1723379,197842,2017.csv,2017,89.70227787433096,10.297722125669042
3026,The Keeper,1916514,0,1916514,2019.csv,2019,0.0,100.0
3027,Old Fashioned,1914090,1914090,0,2015.csv,2015,100.0,0.0
3028,Professor Marston & the Wonder Women,1899615,1584759,314856,2017.csv,2017,83.42527301584795,16.57472698415205
3029,Jurassic Park 2020 Re-release,1899492,1386600,512892,2020.csv,2020,72.99846485270798,27.00153514729201
3030,Frank,1897363,645186,1252177,2014.csv,2014,34.004352356402016,65.99564764359799
3031,Game of Thrones Season 4 Finale,1896092,1896092,0,2015.csv,2015,100.0,0.0
3032,The Art of Getting By,1892130,1430241,461889,2011.csv,2011,75.58893944919218,24.41106055080782
3033,The Mighty Macs,1891936,1891936,0,2011.csv,2011,100.0,0.0
3034,Awake: The Life of Yogananda,1891918,1539680,352238,2014.csv,2014,81.38196264320123,18.618037356798762
3035,Red Lips,1889869,136163,1753706,2011.csv,2011,7.204890921010927,92.79510907898907
3036,Tusk,1882074,1826705,55369,2014.csv,2014,97.05808592010729,2.941914079892714
3037,Kill Your Darlings,1877924,1030064,847860,2013.csv,2013,54.851208036107955,45.148791963892045
3038,Fantastic Fungi,1877675,1788322,89353,2019.csv,2019,95.24129575139467,4.758704248605323
3039,Red State,1874460,1104682,769778,2011.csv,2011,58.93334613702079,41.0666538629792
3040,Last Flag Flying,1872950,965481,907469,2017.csv,2017,51.548679890013084,48.451320109986916
3041,The Whistleblower,1870392,1124966,745426,2011.csv,2011,60.146001479903674,39.853998520096326
3042,Purple Rain 2016 Re-release,1868929,1868075,854,2016.csv,2016,99.95430538024719,0.0456946197528103
3043,Inseparables,1864605,6258,1858347,2016.csv,2016,0.3356206810557732,99.66437931894423
3044,Matthias & Maxime,1863999,374739,1489260,2019.csv,2019,20.104034390576388,79.89596560942361
3045,A Better Life,1863506,1759252,104254,2011.csv,2011,94.40549158414301,5.594508415856992
3046,Girlhood,1862990,60765,1802225,2014.csv,2014,3.2616922259378742,96.73830777406212
3047,The Hallow,1862407,13906,1848501,2015.csv,2015,0.7466681557790537,99.25333184422095
3048,The Dark Horse,1862114,67533,1794581,2014.csv,2014,3.6266845101857355,96.37331548981426
3049,The Pact,1855647,2488,1853159,2018.csv,2018,0.13407722481700454,99.865922775183
3050,Sweet Country,1847693,104297,1743396,2018.csv,2018,5.644714787575642,94.35528521242435
3051,Crooked Arrows,1832541,1832541,0,2012.csv,2012,100.0,0.0
3052,99 Homes,1828232,1411927,416305,2015.csv,2015,77.22909346297406,22.770906537025937
3053,Grease 2018 Re-release,1827688,1213413,614275,2018.csv,2018,66.39059839534976,33.609401604650245
3054,Rams,1826583,149250,1677333,2015.csv,2015,8.170994693370078,91.82900530662992
3055,A Somewhat Gentle Man,1826459,37743,1788716,2010.csv,2010,2.066457555302364,97.93354244469764
3056,The Little Stranger,1824902,713143,1111759,2018.csv,2018,39.07842722513318,60.92157277486682
3057,Mozart's Sister,1824891,707885,1117006,2010.csv,2010,38.79053598269705,61.20946401730295
3058,Infinitely Polar Bear,1824678,1430655,394023,2015.csv,2015,78.40588860061885,21.594111399381152
3059,Human Flow,1824537,527845,1296692,2017.csv,2017,28.930353289629096,71.0696467103709
3060,The Seagull,1820461,1252960,567501,2018.csv,2018,68.8265225127042,31.1734774872958
3061,Luv Shuv Tey Chicken Khurana,1813916,143507,1670409,2012.csv,2012,7.911446836567956,92.08855316343204
3062,The Monk,1809527,13472,1796055,2011.csv,2011,0.7445039504798767,99.25549604952012
3063,The Other Side of Heaven 2: Fire of Faith,1807216,1807216,0,2019.csv,2019,100.0,0.0
3064,Moses,1807117,1807117,0,2018.csv,2018,100.0,0.0
3065,The Face of Love,1806548,350006,1456542,2013.csv,2013,19.374298385650423,80.62570161434958
3066,Elvis & Nixon,1798432,1055287,743145,2016.csv,2016,58.67817076208608,41.32182923791392
3067,The Polar Express 2010 IMAX Release,1798274,672796,1125478,2010.csv,2010,37.41343087872037,62.586569121279624
3068,Mine,1788934,0,1788934,2016.csv,2016,0.0,100.0
3069,Harry Potter IMAX Marathon,1784557,1729226,55331,2016.csv,2016,96.89945459853621,3.1005454014637808
3070,Soldiers of Fortune,1784286,38898,1745388,2012.csv,2012,2.180031676536161,97.81996832346384
3071,Song to Song,1778021,443684,1334337,2017.csv,2017,24.95381100673164,75.04618899326836
3072,Ondine,1777019,550472,1226547,2010.csv,2010,30.977271486686416,69.0227285133136
3073,Tom of Finland,1776931,378296,1398635,2017.csv,2017,21.28929035511227,78.71070964488773
3074,The Diary of a Teenage Girl,1775133,1477002,298131,2015.csv,2015,83.2051457552758,16.794854244724196
3075,Polaroid,1772204,0,1772204,2019.csv,2019,0.0,100.0
3076,Dior and I,1769832,1028953,740879,2015.csv,2015,58.13845607944709,41.86154392055291
3077,I Saw the Light,1767963,1646788,121175,2016.csv,2016,93.14606697085856,6.853933029141447
3078,Invisible Life,1766249,146535,1619714,2019.csv,2019,8.296395355354766,91.70360464464522
3079,Game,1764828,139528,1625300,2011.csv,2011,7.906039568728511,92.0939604312715
3080,Great Performances at the Met: Puccini: La Bohème,1764201,1764201,0,2018.csv,2018,100.0,0.0
3081,Tales of the Night,1762194,10975,1751219,2011.csv,2011,0.6228031646912883,99.37719683530871
3082,Flipped,1755212,1755212,0,2010.csv,2010,100.0,0.0
3083,Great Performances at the Met: Massenet: Cendrillon,1747259,1243306,503953,2018.csv,2018,71.15751013444486,28.842489865555137
3084,Beast,1744071,800365,943706,2018.csv,2018,45.890620278646914,54.10937972135309
3085,"Turn Me On, Dammit!",1743743,126085,1617658,2011.csv,2011,7.230710030090444,92.76928996990955
3086,Wuthering Heights,1742215,100915,1641300,2011.csv,2011,5.792339062630043,94.20766093736995
3087,First Position,1730824,1014071,716753,2012.csv,2012,58.58891487522706,41.41108512477294
3088,After Love,1728251,13693,1714558,2016.csv,2016,0.7923038956725614,99.20769610432744
3089,Girl Rising,1727259,1727259,0,2013.csv,2013,100.0,0.0
3090,Diana Vreeland: The Eye Has to Travel,1721472,1017579,703893,2012.csv,2012,59.11098176444345,40.88901823555655
3091,A Faithful Man,1720605,77491,1643114,2018.csv,2018,4.503706545081527,95.49629345491847
3092,The Souvenir,1719157,1036737,682420,2019.csv,2019,60.30496342102553,39.69503657897447
3093,Weiner,1715955,1676108,39847,2016.csv,2016,97.67785285744672,2.322147142553272
3094,"To Joey, with Love",1709073,1709073,0,2016.csv,2016,100.0,0.0
3095,Paradise: Love,1709036,24267,1684769,2012.csv,2012,1.419923278386178,98.58007672161382
3096,"Men, Women & Children",1705908,705908,1000000,2014.csv,2014,41.38019166332534,58.61980833667466
3097,The Oscar Nominated Short Films 2012: Live Action,1702415,1702415,0,2012.csv,2012,100.0,0.0
3098,Meet the Patels,1700681,1700681,0,2015.csv,2015,100.0,0.0
3099,Tekken,1697207,0,1697207,2010.csv,2010,0.0,100.0
3100,The Wild Pear Tree,1696258,34014,1662244,2018.csv,2018,2.0052374108184017,97.99476258918159
3101,Dunkirk 2017 Re-release,1695119,1695119,0,2017.csv,2017,100.0,0.0
3102,All Good Things 2010 Re-release,1689646,582024,1107622,2010.csv,2010,34.44650536266177,65.55349463733823
3103,Slamma Jamma,1687000,1687000,0,2017.csv,2017,100.0,0.0
3104,Tim's Vermeer,1686917,1671377,15540,2014.csv,2014,99.07879285110056,0.921207148899442
3105,Janis: Little Girl Blue,1683166,410465,1272701,2015.csv,2015,24.38648356727738,75.61351643272262
3106,The Bride,1682689,0,1682689,2015.csv,2015,0.0,100.0
3107,Detachment,1681521,72689,1608832,2012.csv,2012,4.3228125013009056,95.67718749869908
3108,The Hunter,1680778,176669,1504109,2011.csv,2011,10.511144243915616,89.48885575608439
3109,In Between,1679952,107977,1571975,2016.csv,2016,6.427386020552968,93.57261397944703
3110,Final Portrait,1677835,461972,1215863,2017.csv,2017,27.5338158996564,72.4661841003436
3111,Nothing Left to Fear,1675381,7886,1667495,2013.csv,2013,0.47069890371205114,99.52930109628795
3112,Ginger & Rosa,1674776,1012973,661803,2012.csv,2012,60.48408861841822,39.51591138158177
3113,Equity,1672306,1605463,66843,2016.csv,2016,96.00294443720229,3.9970555627977173
3114,A Brother's Love,1671969,539524,1132445,2019.csv,2019,32.26878010298038,67.73121989701963
3115,Vanishing on 7th Street,1671196,22729,1648467,2011.csv,2011,1.3600439445762196,98.63995605542378
3116,The Double,1662515,200406,1462109,2014.csv,2014,12.054387479210714,87.94561252078928
3117,The Comedian,1659002,1659002,0,2016.csv,2016,100.0,0.0
3118,Rustom,1658594,1087419,571175,2016.csv,2016,65.56269949125586,34.43730050874415
3119,Rockstar,1651601,986697,664904,2011.csv,2011,59.74185048325836,40.25814951674164
3120,Namaste England,1649863,104156,1545707,2018.csv,2018,6.313009019536773,93.68699098046322
3121,Two Lives,1649260,22620,1626640,2012.csv,2012,1.3715241987315525,98.62847580126845
3122,Dough,1647429,1148304,499125,2016.csv,2016,69.7027914404809,30.297208559519106
3123,The Letters,1647416,1647416,0,2015.csv,2015,100.0,0.0
3124,The Little Hours,1647175,1647175,0,2017.csv,2017,100.0,0.0
3125,Short Term 12,1645164,1013100,632064,2013.csv,2013,61.580486808609955,38.41951319139004
3126,Deerskin,1641693,0,1641693,2019.csv,2019,0.0,100.0
3127,A Family Man,1641235,0,1641235,2017.csv,2017,0.0,100.0
3128,Sorry Angel,1636273,30628,1605645,2018.csv,2018,1.8718147888524712,98.12818521114754
3129,Student of the Year 2,1635907,778566,857341,2019.csv,2019,47.5923142330218,52.4076857669782
3130,Mohenjo Daro,1630231,1264339,365892,2016.csv,2016,77.55581877660282,22.444181223397173
3131,Iris,1620708,1310678,310030,2015.csv,2015,80.87070588903121,19.129294110968786
3132,All You Need Is Love,1620654,0,1620654,2014.csv,2014,0.0,100.0
3133,I Still See You,1620637,1359,1619278,2018.csv,2018,0.08385591591454472,99.91614408408546
3134,Son of Sardaar,1618361,771789,846572,2012.csv,2012,47.689545163285565,52.31045483671443
3135,Grand Piano,1618085,22555,1595530,2013.csv,2013,1.3939317155773645,98.60606828442263
3136,Batman Begins 2012 Re-release,1612434,1508658,103776,2012.csv,2012,93.56401564343099,6.435984356569014
3137,Singin' in the Rain 2012 Re-release,1609789,1608925,864,2012.csv,2012,99.94632836974287,0.05367163025713308
3138,Walk With Me,1606705,726726,879979,2017.csv,2017,45.23082955489651,54.76917044510349
3139,More Than Honey,1604609,79772,1524837,2012.csv,2012,4.971429176827502,95.0285708231725
3140,We are the Best!,1604273,180590,1423683,2013.csv,2013,11.256812275716166,88.74318772428383
3141,Monos,1601199,406473,1194726,2019.csv,2019,25.385539211553343,74.61446078844666
3142,Crazy Mad Lover,1597269,993031,604238,2011.csv,2011,62.17055486583662,37.82944513416338
3143,Great Performances at the Met: Verdi: Aida,1595902,1595902,0,2018.csv,2018,100.0,0.0
3144,Queen of the Desert,1592853,0,1592853,2015.csv,2015,0.0,100.0
3145,Beanpole,1591621,196258,1395363,2019.csv,2019,12.330699331059341,87.66930066894066
3146,I Am,1591034,1591034,0,2011.csv,2011,100.0,0.0
3147,The Crossing,1589212,90896,1498316,2019.csv,2019,5.719564161357956,94.28043583864203
3148,Dance Academy: The Movie,1586858,0,1586858,2017.csv,2017,0.0,100.0
3149,Lovelace,1585583,356582,1229001,2013.csv,2013,22.48901508151891,77.51098491848109
3150,Make Your Move,1583687,125106,1458581,2012.csv,2012,7.899667042793178,92.10033295720682
3151,The Bay,1581252,30668,1550584,2012.csv,2012,1.9394758077776346,98.06052419222236
3152,Lou!,1581125,287,1580838,2014.csv,2014,0.018151632540121747,99.98184836745988
3153,The Stray,1579440,1579440,0,2017.csv,2017,100.0,0.0
3154,Lay the Favorite,1576687,20998,1555689,2012.csv,2012,1.3317798649953985,98.6682201350046
3155,Adore,1575749,318982,1256767,2013.csv,2013,20.24319863125409,79.75680136874591
3156,Genesis: Paradise Lost,1575000,1575000,0,2017.csv,2017,100.0,0.0
3157,Teri Meri Kahaani,1574703,781196,793507,2012.csv,2012,49.609100890771145,50.39089910922885
3158,Teen Spirit,1573601,441366,1132235,2019.csv,2019,28.04815197753433,71.95184802246567
3159,Caesar Must Die,1567339,76908,1490431,2012.csv,2012,4.906915479038038,95.09308452096195
3160,"Bless Me, Ultima",1561962,1561962,0,2013.csv,2013,100.0,0.0
3161,Persecuted,1558836,1558836,0,2014.csv,2014,100.0,0.0
3162,The Kid,1553483,1508593,44890,2019.csv,2019,97.11036425889436,2.8896357411056317
3163,Still Mine,1552730,1159336,393394,2013.csv,2013,74.66436534362059,25.33563465637941
3164,Yardie,1551163,36012,1515151,2018.csv,2018,2.32161288014219,97.67838711985782
3165,Tel Aviv on Fire,1548893,506145,1042748,2019.csv,2019,32.67785444184976,67.32214555815024
3166,Cold in July,1547630,427418,1120212,2014.csv,2014,27.6175830140279,72.3824169859721
3167,Fed Up,1546229,1538899,7330,2014.csv,2014,99.52594344046062,0.47405655953936965
3168,"New York, New York",1545352,92377,1452975,2016.csv,2016,5.977731934213047,94.02226806578695
3169,The Lords of Salem,1544989,1165882,379107,2013.csv,2013,75.46215539398662,24.537844606013376
3170,Mystery Train,1544973,1541218,3755,2018.csv,2018,99.7569536813912,0.24304631860880416
3171,Rampart,1543613,972512,571101,2012.csv,2012,63.00231988199114,36.99768011800885
3172,The Wedding Plan,1542345,1412404,129941,2016.csv,2016,91.57510154991263,8.424898450087367
3173,The Chaperone,1541223,600654,940569,2019.csv,2019,38.972556210230444,61.027443789769556
3174,Reaching for the Moon,1534391,45502,1488889,2013.csv,2013,2.9654762052175747,97.03452379478243
3175,Love,1533874,309200,1224674,2012.csv,2012,20.15810946661851,79.84189053338149
3176,The Bullet Vanishes,1528580,117629,1410951,2012.csv,2012,7.695311988904735,92.30468801109527
3177,Gold,1528185,5539,1522646,2017.csv,2017,0.36245611624247065,99.63754388375753
3178,Certain Women,1526698,1087585,439113,2016.csv,2016,71.23773005532202,28.762269944677993
3179,Mandy,1523052,1214525,308527,2018.csv,2018,79.74284528696329,20.25715471303672
3180,Shaadi Ke Side Effects,1521778,921277,600501,2014.csv,2014,60.53951364785139,39.46048635214861
3181,Young Ahmed,1520922,21291,1499631,2019.csv,2019,1.3998745497796732,98.60012545022032
3182,Princess Mononoke 2018 Re-release,1519321,1423877,95444,2018.csv,2018,93.71798323066686,6.2820167693331435
3183,The Dark Knight 2012 Re-release,1513086,1513086,0,2012.csv,2012,100.0,0.0
3184,My Golden Days,1509773,269144,1240629,2015.csv,2015,17.826785881056292,82.1732141189437
3185,Take a Shot,1508912,564489,944423,2011.csv,2011,37.410332743062554,62.58966725693745
3186,The Daughter,1505434,26376,1479058,2016.csv,2016,1.752052896374069,98.24794710362593
3187,The Kings of Summer,1501595,1315590,186005,2013.csv,2013,87.61283834855604,12.387161651443964
3188,Priceless,1499605,1499605,0,2016.csv,2016,100.0,0.0
3189,Moka,1493067,129547,1363520,2016.csv,2016,8.67656977215356,91.32343022784643
3190,The Artist and the Model,1492780,127958,1364822,2012.csv,2012,8.571792226583957,91.42820777341605
3191,Mully,1489771,1489771,0,2017.csv,2017,100.0,0.0
3192,Patti Cake$,1482356,800148,682208,2017.csv,2017,53.97812671180202,46.02187328819798
3193,Oasis: Supersonic,1478119,242867,1235252,2016.csv,2016,16.430815110285437,83.56918488971456
3194,The Miseducation of Cameron Post,1474577,904703,569874,2018.csv,2018,61.3533915149904,38.6466084850096
3195,Good Kill,1474471,316472,1157999,2015.csv,2015,21.463426544163973,78.53657345583602
3196,Freeheld,1474471,573335,901136,2015.csv,2015,38.88411504871917,61.11588495128083
3197,Mausam,1473341,728316,745025,2011.csv,2011,49.43295543937215,50.56704456062785
3198,De De Pyaar De,1473116,425934,1047182,2019.csv,2019,28.91381262575384,71.08618737424615
3199,A Pigeon Sat on a Branch Reflecting on Existence,1472431,222989,1249442,2014.csv,2014,15.144275011868128,84.85572498813187
3200,Jimmy P.,1470582,30283,1440299,2013.csv,2013,2.0592527312315805,97.94074726876842
3201,Violeta Went to Heaven,1466032,21496,1444536,2011.csv,2011,1.4662708590262696,98.53372914097373
3202,Thelma,1463727,147391,1316336,2017.csv,2017,10.069568983833733,89.93043101616627
3203,Greed,1460431,355308,1105123,2020.csv,2020,24.328982334666957,75.67101766533304
3204,Life of Crime,1456675,265452,1191223,2014.csv,2014,18.22314517651501,81.776854823485
3205,The Other Woman,1451343,25423,1425920,2010.csv,2010,1.7516879193960353,98.24831208060397
3206,The Disappearance of Eleanor Rigby: Them,1448076,587774,860302,2014.csv,2014,40.58999665763399,59.41000334236601
3207,The City of Your Final Destination,1444401,493296,951105,2010.csv,2010,34.152288734222694,65.84771126577729
3208,Shameless,1443479,679866,763613,2013.csv,2013,47.09912648538704,52.900873514612954
3209,The Dawn Wall 2018 Re-release,1442013,970032,471981,2018.csv,2018,67.26929646265324,32.73070353734675
3210,Vox Lux,1439539,727119,712420,2018.csv,2018,50.51054538987829,49.48945461012171
3211,Tomboy,1437501,129834,1307667,2011.csv,2011,9.031924151704938,90.96807584829506
3212,My Friend Dahmer,1436751,1361611,75140,2017.csv,2017,94.7701445831602,5.2298554168398
3213,Restrepo,1436391,1330894,105497,2010.csv,2010,92.65541207094725,7.344587929052744
3214,Kai Po Che,1435272,1122527,312745,2013.csv,2013,78.21005356475985,21.789946435240147
3215,The Devil's Hand,1428494,5746,1422748,2014.csv,2014,0.4022418015056416,99.59775819849436
3216,The Zero Theorem,1428362,257706,1170656,2014.csv,2014,18.042064966724123,81.95793503327587
3217,Fairy Tail: Dragon Cry,1420035,519461,900574,2017.csv,2017,36.58085892249135,63.419141077508655
3218,Black Butterflies,1416573,0,1416573,2011.csv,2011,0.0,100.0
3219,It 2019 Re-release,1414696,1347126,67570,2019.csv,2019,95.22370883921351,4.776291160786487
3220,The Wolfpack,1414140,1301696,112444,2015.csv,2015,92.04859490573777,7.951405094262237
3221,Parkland,1412181,653651,758530,2013.csv,2013,46.28663039652849,53.713369603471506
3222,Lazer Team,1406538,1186426,220112,2016.csv,2016,84.35079606807638,15.64920393192363
3223,Just a Sigh,1406331,75531,1330800,2013.csv,2013,5.370783976176305,94.62921602382369
3224,El Chicano,1404646,1400603,4043,2019.csv,2019,99.71216947188117,0.28783052811882853
3225,Haider,1404307,1048143,356164,2014.csv,2014,74.63773946864895,25.36226053135105
3226,Universal Soldier: Day of Reckoning,1402307,5460,1396847,2012.csv,2012,0.38935839299097846,99.61064160700901
3227,Saheb Biwi Aur Gangster 3,1401894,0,1401894,2018.csv,2018,0.0,100.0
3228,Born to Be Blue 2016 Re-release,1401411,678203,723208,2016.csv,2016,48.39429689077651,51.60570310922349
3229,For Sama,1397546,43796,1353750,2019.csv,2019,3.133778780805784,96.86622121919422
3230,Maggie,1394052,187112,1206940,2015.csv,2015,13.42216789617604,86.57783210382397
3231,Light of My Life,1392898,20056,1372842,2019.csv,2019,1.4398757123637194,98.56012428763628
3232,White Material,1392434,304020,1088414,2010.csv,2010,21.833709892174422,78.16629010782557
3233,Holiday: A Soldier is Never Off Duty,1390054,706893,683161,2014.csv,2014,50.85363590191461,49.1463640980854
3234,"Oslo, August 31st",1386378,101475,1284903,2011.csv,2011,7.319432362602408,92.68056763739759
3235,"For a Good Time, Call...",1386088,1251749,134339,2012.csv,2012,90.30804681953816,9.691953180461848
3236,Alien 2019 Re-release,1385671,833658,552013,2014.csv,2014,60.16276590907943,39.83723409092057
3237,National Lampoon's Christmas Vacation 2019 Re-release,1385620,1385620,0,2019.csv,2019,100.0,0.0
3238,House of Tolerance,1384443,19327,1365116,2011.csv,2011,1.3960126924691012,98.6039873075309
3239,Sometimes Always Never,1377856,0,1377856,2018.csv,2018,0.0,100.0
3240,Swimming with Men,1377748,24708,1353040,2018.csv,2018,1.79336134039026,98.20663865960974
3241,Ma ma,1375709,47258,1328451,2015.csv,2015,3.435174153836313,96.56482584616369
3242,Khoobsurat,1375623,710508,665115,2014.csv,2014,51.64990698759762,48.350093012402375
3243,Stefan Zweig: Farewell to Europe,1370772,78372,1292400,2016.csv,2016,5.7173621871470965,94.2826378128529
3244,A Good Old Fashioned Orgy,1369485,200227,1169258,2011.csv,2011,14.620605556103206,85.3793944438968
3245,The Ardennes,1366879,5638,1361241,2015.csv,2015,0.4124725012235904,99.58752749877641
3246,Sarileru Neekevvaru,1366335,821000,545335,2020.csv,2020,60.0877530034728,39.91224699652721
3247,The Salvation,1363964,44903,1319061,2014.csv,2014,3.292095685809889,96.7079043141901
3248,National Theater Live: Cyrano de Bergerac 2020 Re-release,1363212,198352,1164860,2020.csv,2020,14.550341399576883,85.44965860042312
3249,Little Italy,1362536,990230,372306,2018.csv,2018,72.6755109589765,27.324489041023504
3250,Gimme Shelter,1362018,1359910,2108,2014.csv,2014,99.8452296518842,0.15477034811581053
3251,Chasing Ice,1358668,1328467,30201,2012.csv,2012,97.77716116078395,2.2228388392160556
3252,Raavan,1356461,708726,647735,2010.csv,2010,52.24816636821848,47.75183363178152
3253,Foxtrot,1356159,618883,737276,2018.csv,2018,45.634988227781555,54.36501177221845
3254,Papa,1356033,26677,1329356,2016.csv,2016,1.9672825071366258,98.03271749286337
3255,The Oscar Nominated Short Films 2011: Live Action,1352152,1352152,0,2011.csv,2011,100.0,0.0
3256,Unforgivable,1351146,154189,1196957,2011.csv,2011,11.411720124990193,88.5882798750098
3257,The Teacher,1350426,64437,1285989,2016.csv,2016,4.771605404516797,95.2283945954832
3258,The Snowtown Murders,1349387,8452,1340935,2011.csv,2011,0.6263584872241988,99.3736415127758
3259,The Cokeville Miracle,1348456,1348456,0,2015.csv,2015,100.0,0.0
3260,Bolshoi Ballet: The Nutcracker,1348248,252935,1095313,2019.csv,2019,18.760272590799318,81.23972740920068
3261,2 Hearts,1341495,1341495,0,2020.csv,2020,100.0,0.0
3262,Saint Maud,1340825,0,1340825,2020.csv,2020,0.0,100.0
3263,The Assistant,1338881,1100313,238568,2020.csv,2020,82.18153816507964,17.818461834920356
3264,Student of the Year,1337281,670086,667195,2012.csv,2012,50.108092465233554,49.89190753476644
3265,Barney Thomson,1336254,0,1336254,2015.csv,2015,0.0,100.0
3266,Great Performances at the Met: Rossini: Semiramide,1332900,1033651,299249,2018.csv,2018,77.54902843424112,22.45097156575887
3267,Ghost in the Shell: The New Movie,1332311,101203,1231108,2015.csv,2015,7.596049270778369,92.40395072922163
3268,Godard Mon Amour,1332204,82264,1249940,2017.csv,2017,6.175030250622277,93.82496974937771
3269,Kapow,1331922,812737,519185,2016.csv,2016,61.01986452660141,38.98013547339859
3270,Ajami,1331651,622403,709248,2010.csv,2010,46.73919818330779,53.260801816692215
3271,13 Minutes,1328233,161531,1166702,2015.csv,2015,12.16134518567149,87.8386548143285
3272,The Ultimate Life,1327841,1327841,0,2013.csv,2013,100.0,0.0
3273,Spirited Away 2019 Re-release,1322927,1322927,0,2019.csv,2019,100.0,0.0
3274,It's a Wonderful Afterlife,1321438,0,1321438,2010.csv,2010,0.0,100.0
3275,The Look of Love,1318468,21252,1297216,2013.csv,2013,1.6118707469578326,98.38812925304217
3276,Erased,1314735,0,1314735,2012.csv,2012,0.0,100.0
3277,Damsels in Distress,1314358,1008455,305903,2012.csv,2012,76.72605180628109,23.273948193718912
3278,Air Racers,1309987,1309987,0,2012.csv,2012,100.0,0.0
3279,Come What May,1309818,37766,1272052,2015.csv,2015,2.883301344156211,97.11669865584379
3280,Dom Hemingway,1307599,523511,784088,2013.csv,2013,40.03605080762527,59.96394919237472
3281,Something in the Air,1305473,85154,1220319,2012.csv,2012,6.522846508506879,93.47715349149313
3282,Great Performances at the Met: Mozart: Così fan tutte,1302949,1302949,0,2018.csv,2018,100.0,0.0
3283,Les Cowboys,1302493,73725,1228768,2015.csv,2015,5.660299134045251,94.33970086595474
3284,Sunset Song,1302482,159714,1142768,2015.csv,2015,12.262280783918703,87.7377192160813
3285,The Room 2017 Re-release,1301103,549602,751501,2017.csv,2017,42.24123685826564,57.75876314173436
3286,Hard to Be a God,1299035,28608,1270427,2014.csv,2014,2.2022501318286265,97.79774986817137
3287,Slow West,1295574,229094,1066480,2015.csv,2015,17.682818580798934,82.31718141920106
3288,Roger Waters - Us + Them,1294480,611644,682836,2019.csv,2019,47.25016995241332,52.74983004758668
3289,No Safe Spaces,1291514,1291514,0,2019.csv,2019,100.0,0.0
3290,The Cakemaker,1287568,875751,411817,2018.csv,2018,68.0159028494029,31.984097150597098
3291,Filmistaan,1282717,45406,1237311,2014.csv,2014,3.5398299079220124,96.46017009207799
3292,I Spit on Your Grave,1278650,93051,1185599,2010.csv,2010,7.277284636139679,92.72271536386032
3293,Howl,1278390,617334,661056,2010.csv,2010,48.28995846337972,51.710041536620274
3294,Black Souls,1278360,101088,1177272,2014.csv,2014,7.9076316530554775,92.09236834694453
3295,The Villain,1278108,730530,547578,2014.csv,2014,57.15714165000141,42.84285834999859
3296,Shed Skin Papa,1278065,13331,1264734,2018.csv,2018,1.04306119015856,98.95693880984145
3297,Yellow Submarine,1273261,992305,280956,2018.csv,2018,77.93413919062941,22.065860809370584
3298,The Women's Balcony,1272517,1200885,71632,2017.csv,2017,94.37084141115601,5.629158588844
3299,Beautifully Broken,1271572,1209645,61927,2018.csv,2018,95.12988647123403,4.870113528765969
3300,Tai ji 1: Cong ling kai shi,1271521,212094,1059427,2012.csv,2012,16.680337957454107,83.3196620425459
3301,Texas Killing Fields,1271319,45469,1225850,2011.csv,2011,3.5765217069830624,96.42347829301694
3302,Fagara,1265949,43417,1222532,2019.csv,2019,3.429601034480852,96.57039896551915
3303,Why Don't You Play in Hell?,1265872,28534,1237338,2013.csv,2013,2.2540983606557377,97.74590163934425
3304,Batla House,1264337,493180,771157,2019.csv,2019,39.007005252555295,60.992994747444705
3305,Valley of Love,1264277,28648,1235629,2015.csv,2015,2.265959121300158,97.73404087869984
3306,Chonda Pierce: Enough,1260116,1260116,0,2017.csv,2017,100.0,0.0
3307,Meerkats,1259616,777595,482021,2012.csv,2012,61.732702664939154,38.267297335060846
3308,The Music of Strangers: Yo-Yo Ma and the Silk Road Ensemble,1259588,1176781,82807,2016.csv,2016,93.42586623562626,6.574133764373748
3309,Gett,1259160,988150,271010,2014.csv,2014,78.47692112201786,21.523078877982147
3310,Guy,1257937,1319,1256618,2018.csv,2018,0.10485421765954893,99.89514578234045
3311,Anna,1257142,4288,1252854,2014.csv,2014,0.34109114165305116,99.65890885834695
3312,Chaar Sahibzaade 2: Rise of Banda Singh Bahadur,1256852,700723,556129,2016.csv,2016,55.75222858379507,44.24777141620493
3313,For a Woman,1252416,32286,1220130,2013.csv,2013,2.5778974398283,97.4221025601717
3314,Demi-soeur,1251642,943,1250699,2013.csv,2013,0.0753410320203381,99.92465896797967
3315,The Ledge,1247188,9216,1237972,2011.csv,2011,0.7389423246535406,99.26105767534646
3316,Midnight's Children,1243980,190022,1053958,2012.csv,2012,15.275325969870899,84.7246740301291
3317,Slumber,1243832,0,1243832,2017.csv,2017,0.0,100.0
3318,1945,1240663,1006193,234470,2017.csv,2017,81.10123377581179,18.898766224188197
3319,The Goonies 2020 Re-release,1236438,825000,411438,2020.csv,2020,66.72392792845254,33.27607207154746
3320,Beyond the Mask,1236094,1236094,0,2015.csv,2015,100.0,0.0
3321,The Blue Room,1232900,254666,978234,2014.csv,2014,20.65585205612783,79.34414794387217
3322,The Cut,1232140,28066,1204074,2014.csv,2014,2.277825571769442,97.72217442823056
3323,Honeyland,1231697,815082,416615,2019.csv,2019,66.17552855937784,33.82447144062217
3324,Life,1231606,0,1231606,2015.csv,2015,0.0,100.0
3325,The Perfect Candidate,1231500,0,1231500,2020.csv,2020,0.0,100.0
3326,True to the Game,1231040,1231040,0,2017.csv,2017,100.0,0.0
3327,Steve McQueen: American Icon,1229782,1229782,0,2017.csv,2017,100.0,0.0
3328,Casablanca 2011 Re-release,1226808,1155330,71478,2011.csv,2011,94.17366042608134,5.8263395739186565
3329,BTS World Tour 'Love Yourself: Speak Yourself' (The Final) Seoul Live Viewing,1226552,1226552,0,2019.csv,2019,100.0,0.0
3330,That Sugar Film,1226399,3500,1222899,2015.csv,2015,0.2853883605580239,99.71461163944197
3331,The Revolution Has Begun,1223419,738525,484894,2013.csv,2013,60.36566376686972,39.63433623313027
3332,Sister,1218174,154659,1063515,2012.csv,2012,12.695969541297055,87.30403045870294
3333,Ilo Ilo,1216181,56773,1159408,2013.csv,2013,4.668137390733781,95.33186260926621
3334,When We Leave,1214076,19631,1194445,2010.csv,2010,1.6169498449849926,98.38305015501501
3335,Woman Thou Art Loosed: On the 7th Day,1213128,1213128,0,2012.csv,2012,100.0,0.0
3336,Clandestine Childhood,1212354,9017,1203337,2012.csv,2012,0.7437596609571132,99.25624033904289
3337,Uncle Boonmee Who Can Recall His Past Lives,1212206,184292,1027914,2010.csv,2010,15.203026548292947,84.79697345170706
3338,Kochadaiiyaan,1210580,817192,393388,2014.csv,2014,67.50417155413108,32.49582844586892
3339,Casino Jack,1209709,1042959,166750,2010.csv,2010,86.2156931956363,13.784306804363695
3340,The Way He Looks,1207841,101451,1106390,2014.csv,2014,8.399367135243795,91.60063286475621
3341,Noble 2014 Re-release,1207386,347321,860065,2014.csv,2014,28.76635972257422,71.23364027742578
3342,Alone in Berlin,1205598,33125,1172473,2016.csv,2016,2.7475991167868563,97.25240088321314
3343,Inequality for All,1205273,1205273,0,2013.csv,2013,100.0,0.0
3344,Meek's Cutoff,1205257,977772,227485,2011.csv,2011,81.12560225744386,18.87439774255615
3345,In the Land of Blood and Honey,1203699,303877,899822,2011.csv,2011,25.245264804573235,74.75473519542678
3346,"Beats, Rhymes & Life: The Travels of A Tribe Called Quest",1200326,1200326,0,2011.csv,2011,100.0,0.0
3347,Phantom,1197759,1034589,163170,2013.csv,2013,86.37705915797753,13.622940842022476
3348,Spirited Away 2017 Re-release,1196791,1196791,0,2017.csv,2017,100.0,0.0
3349,The Captain,1196669,109226,1087443,2018.csv,2018,9.127503094005109,90.8724969059949
3350,Great Performances at the Met: Saint-Saëns: Samson et Dalila,1195758,1195758,0,2018.csv,2018,100.0,0.0
3351,Repentance,1194961,1189612,5349,2014.csv,2014,99.55237032840402,0.4476296715959767
3352,The First Grader,1194710,332000,862710,2011.csv,2011,27.78917059370056,72.21082940629944
3353,When You're Strange,1194182,246078,948104,2010.csv,2010,20.606406728622606,79.3935932713774
3354,Free Men,1192651,53810,1138841,2011.csv,2011,4.511797667549015,95.48820233245098
3355,Kingdom Men Rising,1188936,1188936,0,2019.csv,2019,100.0,0.0
3356,Shubh Mangal Savdhan,1188541,689874,498667,2017.csv,2017,58.04376963016,41.95623036984
3357,Kill the Irishman,1188194,1188194,0,2011.csv,2011,100.0,0.0
3358,Dead Snow 2: Red vs. Dead,1187477,37473,1150004,2014.csv,2014,3.1556821732126177,96.84431782678739
3359,Los Domirriqueños 2,1187280,1187280,0,2019.csv,2019,100.0,0.0
3360,Savage,1183965,0,1183965,2020.csv,2020,0.0,100.0
3361,Remember 2016 Re-release,1181023,637555,543468,2016.csv,2016,53.983283983461796,46.016716016538204
3362,Fire at Sea,1178377,120933,1057444,2016.csv,2016,10.26267484854168,89.73732515145832
3363,Any Body Can Dance 2,1176958,892133,284825,2015.csv,2015,75.79990110097387,24.200098899026134
3364,Marie's Story,1173514,11720,1161794,2014.csv,2014,0.9987098577434952,99.00129014225651
3365,Raanjhanaa,1171761,903232,268529,2013.csv,2013,77.08329599636787,22.91670400363214
3366,The Innkeepers,1169750,78396,1091354,2012.csv,2012,6.701944860012824,93.29805513998718
3367,Dark Tide,1167612,0,1167612,2012.csv,2012,0.0,100.0
3368,Great Performances at the Met: Verdi: Luisa Miller,1166858,1166858,0,2018.csv,2018,100.0,0.0
3369,Her & Him,1166781,857986,308795,2016.csv,2016,73.53445076668201,26.465549233317994
3370,You Ain't Seen Nothin' Yet,1166740,18929,1147811,2012.csv,2012,1.6223837358794588,98.37761626412053
3371,Vaxxed: From Cover-Up to Catastrophe,1163265,1163265,0,2016.csv,2016,100.0,0.0
3372,Louder Than Bombs,1160724,163807,996917,2015.csv,2015,14.112484966279668,85.88751503372033
3373,Where Hope Grows,1159072,1156000,3072,2015.csv,2015,99.73496038209878,0.2650396179012175
3374,Breathe,1158695,42297,1116398,2014.csv,2014,3.6503998032269056,96.34960019677308
3375,Darling Companion,1157257,793815,363442,2012.csv,2012,68.59452999636208,31.405470003637916
3376,Napping Princess,1156847,48198,1108649,2017.csv,2017,4.1663245009927845,95.83367549900721
3377,Embrace: The Documentary,1155263,629126,526137,2016.csv,2016,54.45738329713667,45.542616702863334
3378,Detective Jagga,1154862,861740,293122,2017.csv,2017,74.61843925940936,25.381560740590654
3379,Step,1152839,1146292,6547,2017.csv,2017,99.43209763028489,0.567902369715112
3380,Liberal Arts,1150681,327345,823336,2012.csv,2012,28.447936482830606,71.5520635171694
3381,Cartel Land,1145923,704352,441571,2015.csv,2015,61.46591001315097,38.53408998684903
3382,National Theatre Live: King Lear,1142561,185305,957256,2018.csv,2018,16.218390090332157,83.78160990966784
3383,Roma,1140769,0,1140769,2018.csv,2018,0.0,100.0
3384,The Song of Names,1138962,1077584,61378,2019.csv,2019,94.61105813890191,5.388941861098088
3385,The Hollars,1138609,1016985,121624,2016.csv,2016,89.31819439333432,10.681805606665677
3386,Fathom Premieres 6 Below: Miracle on the Mountain,1135531,14838,1120693,2017.csv,2017,1.306701446283721,98.69329855371628
3387,Cell,1133031,0,1133031,2016.csv,2016,0.0,100.0
3388,Miral,1132843,373420,759423,2010.csv,2010,32.96308491114832,67.03691508885169
3389,Dancer,1131649,71917,1059732,2016.csv,2016,6.355062391253825,93.64493760874618
3390,Stranger by the Lake,1131241,325196,806045,2013.csv,2013,28.746836438919736,71.25316356108027
3391,Weekend,1128477,484592,643885,2011.csv,2011,42.94212465118917,57.057875348810825
3392,In the Name Of,1127938,9883,1118055,2013.csv,2013,0.8762006422338816,99.12379935776612
3393,Look Away,1119537,0,1119537,2018.csv,2018,0.0,100.0
3394,Papa Hemingway in Cuba,1117399,1115615,1784,2016.csv,2016,99.84034351203105,0.159656487968935
3395,The Mill and the Cross,1116180,312187,803993,2011.csv,2011,27.96923435288215,72.03076564711785
3396,Great Performances at the Met: Donizetti: L'Elisir d'Amore,1115018,1115018,0,2018.csv,2018,100.0,0.0
3397,A War,1114663,122902,991761,2015.csv,2015,11.025933398704362,88.97406660129565
3398,The Selfish Giant,1114027,12189,1101838,2013.csv,2013,1.094138651935725,98.90586134806428
3399,Walking with the Enemy,1112592,1112592,0,2014.csv,2014,100.0,0.0
3400,The Overnight,1110522,1110522,0,2015.csv,2015,100.0,0.0
3401,My Neighbor Totoro 2019 Re-release,1105564,1105564,0,2019.csv,2019,100.0,0.0
3402,"Peace, Love & Misunderstanding",1105020,590700,514320,2012.csv,2012,53.45604604441549,46.54395395558451
3403,The Heart Specialist,1103037,1103037,0,2011.csv,2011,100.0,0.0
3404,The Insanity of God,1102525,1102525,0,2016.csv,2016,100.0,0.0
3405,El Coyote,1101470,1101470,0,2019.csv,2019,100.0,0.0
3406,Beyond the Reach,1100432,45895,1054537,2015.csv,2015,4.170634805240124,95.82936519475987
3407,Kajillionaire,1100341,531430,568911,2020.csv,2020,48.29684615950873,51.70315384049127
3408,Columbus,1093077,1017107,75970,2017.csv,2017,93.04989492963442,6.9501050703655824
3409,Northern Soul,1092359,8886,1083473,2014.csv,2014,0.8134688321330259,99.18653116786697
3410,Bombshell: The Hedy Lamarr Story,1092277,820300,271977,2017.csv,2017,75.09999752809956,24.900002471900443
3411,The Son of No One,1091132,30680,1060452,2011.csv,2011,2.811758797285755,97.18824120271424
3412,The Goonies 2019 Re-release,1089463,864378,225085,2019.csv,2019,79.33982154510983,20.66017845489016
3413,The Sky Is Pink,1088641,652592,436049,2019.csv,2019,59.94556515876216,40.054434841237835
3414,Misbehaviour,1087755,0,1087755,2020.csv,2020,0.0,100.0
3415,Sunset,1083299,164906,918393,2018.csv,2018,15.222574746215034,84.77742525378497
3416,Jesus Is King,1082629,973000,109629,2019.csv,2019,89.87381642280042,10.126183577199576
3417,Mystify: Michael Hutchence,1082456,289573,792883,2019.csv,2019,26.75147996777698,73.24852003222301
3418,Page One: Inside the New York Times,1077982,1067028,10954,2011.csv,2011,98.98384203075747,1.016157969242529
3419,Merci pour tout,1073969,1073969,0,2019.csv,2019,100.0,0.0
3420,The First Monday in May,1072943,527474,545469,2016.csv,2016,49.161418640132794,50.838581359867206
3421,Killing Season,1071322,39881,1031441,2013.csv,2013,3.7225969409757287,96.27740305902427
3422,Chal Mera Putt 2,1070997,445000,625997,2020.csv,2020,41.55006970140906,58.449930298590935
3423,Love and Monsters,1070714,1070714,0,2020.csv,2020,100.0,0.0
3424,Au nom de ma fille,1066493,1623,1064870,2016.csv,2016,0.15218102697345412,99.84781897302655
3425,The Oogieloves in the Big Balloon Adventure,1065907,1065907,0,2012.csv,2012,100.0,0.0
3426,50 to 1,1064454,1064454,0,2014.csv,2014,100.0,0.0
3427,La Mission,1062941,1062941,0,2010.csv,2010,100.0,0.0
3428,Dangerous Ishq,1062825,0,1062825,2012.csv,2012,0.0,100.0
3429,Carlos,1059369,145526,913843,2010.csv,2010,13.73704535435717,86.26295464564284
3430,Hope Gap,1056908,104732,952176,2020.csv,2020,9.909282548717579,90.09071745128242
3431,Bennett's War,1056416,1056416,0,2019.csv,2019,100.0,0.0
3432,The Tax Collector,1055718,942666,113052,2020.csv,2020,89.29145851448966,10.708541485510334
3433,Borgman,1052010,57474,994536,2013.csv,2013,5.463256052699119,94.53674394730088
3434,No One Lives,1048704,74918,973786,2013.csv,2013,7.143865189796167,92.85613481020383
3435,Princess Mononoke 2019 Re-release,1046446,1046446,0,2019.csv,2019,100.0,0.0
3436,Becky,1045873,1003700,42173,2020.csv,2020,95.9676748515355,4.032325148464489
3437,A Brilliant Young Mind,1043620,171793,871827,2015.csv,2015,16.461259845537647,83.53874015446236
3438,Made In Mexico,1042673,151133,891540,2012.csv,2012,14.494764897527796,85.5052351024722
3439,Spark: A Space Tail,1040689,196458,844231,2017.csv,2017,18.877685840822764,81.12231415917724
3440,Befikre,1040421,498000,542421,2016.csv,2016,47.86523916760619,52.13476083239381
3441,The Dark Crystal 2018 Re-release,1036956,1036956,0,2018.csv,2018,100.0,0.0
3442,Noah,1035603,1035603,0,2019.csv,2019,100.0,0.0
3443,The Last Shift,1035128,1034467,661,2020.csv,2020,99.93614316297115,0.06385683702885055
3444,Unconditional,1034448,1005800,28648,2012.csv,2012,97.23060028150279,2.769399718497208
3445,Ain't Them Bodies Saints,1031243,396519,634724,2013.csv,2013,38.45058827065977,61.54941172934022
3446,We Are Family,1031070,638144,392926,2010.csv,2010,61.89143317136568,38.10856682863433
3447,Knight of Cups,1026288,566006,460282,2015.csv,2015,55.15079587796018,44.849204122039815
3448,Casablanca 2017 Re-release,1024560,1024560,0,2017.csv,2017,100.0,0.0
3449,Tangerines,1024132,144501,879631,2015.csv,2015,14.109606964727202,85.8903930352728
3450,Color Out of Space,1023510,765561,257949,2020.csv,2020,74.79760823050093,25.202391769499076
3451,Great Performances at the Met: Puccini: La Fanciulla del West,1023233,1023233,0,2018.csv,2018,100.0,0.0
3452,Leaves of Grass,1018753,70066,948687,2010.csv,2010,6.877623918653492,93.12237608134652
3453,The Oscar Nominated Short Films 2010: Live Action,1018169,1018169,0,2010.csv,2010,100.0,0.0
3454,Husband Material,1016545,567417,449128,2018.csv,2018,55.818188078245434,44.18181192175457
3455,Big Stone Gap,1012804,1009301,3503,2015.csv,2015,99.65412853819693,0.34587146180307343
3456,Transit,1012747,815290,197457,2018.csv,2018,80.50283042062824,19.497169579371747
3457,L'attesa,1010766,55804,954962,2015.csv,2015,5.520961330317799,94.4790386696822
3458,Elvis: The Comeback Special,1010657,1010657,0,2018.csv,2018,100.0,0.0
3459,Far from Men,1010485,5336,1005149,2015.csv,2015,0.5280632567529453,99.47193674324706
3460,Cold Blood,1009888,5083,1004805,2019.csv,2019,0.5033231407839285,99.49667685921607
3461,The Song,1009620,1009620,0,2014.csv,2014,100.0,0.0
3462,Francofonia,1008154,307040,701114,2015.csv,2015,30.45566451157264,69.54433548842736
3463,Sidewalls,1008116,2377,1005739,2011.csv,2011,0.23578635791912833,99.76421364208086
3464,Ghost House,1004155,0,1004155,2017.csv,2017,0.0,100.0
3465,Faith of Our Fathers,1004105,1004105,0,2015.csv,2015,100.0,0.0
3466,Kiki's Delivery Service 2019 Re-release,1004057,1004057,0,2019.csv,2019,100.0,0.0
3467,"Polina, danser sa vie",1000474,165203,835271,2016.csv,2016,16.512473087756405,83.4875269122436
3468,The Workshop,1000056,22061,977995,2017.csv,2017,2.205976465317942,97.79402353468207
3469,Gabbar is Back,998582,534601,463981,2015.csv,2015,53.536014067948344,46.46398593205165
3470,National Theatre Live: Antony & Cleopatra,998079,83672,914407,2018.csv,2018,8.383304327613345,91.61669567238665
3471,Photograph,996171,344534,651637,2019.csv,2019,34.5858291397762,65.41417086022379
3472,Burn,996103,996103,0,2012.csv,2012,100.0,0.0
3473,Long Live Freedom 2014 Re-release,995990,48541,947449,2014.csv,2014,4.873643309671784,95.12635669032822
3474,Child's Pose,994126,97170,896956,2013.csv,2013,9.774414913200138,90.22558508679987
3475,Labyrinth 2018 Re-release,993336,993336,0,2013.csv,2013,100.0,0.0
3476,Blue Ruin,993313,258384,734929,2014.csv,2014,26.012344547992427,73.98765545200757
3477,Beyond Skyline,992181,0,992181,2017.csv,2017,0.0,100.0
3478,Blackthorn,987883,200558,787325,2011.csv,2011,20.301796872706586,79.69820312729341
3479,The Greatest,985181,114766,870415,2010.csv,2010,11.64922993845801,88.350770061542
3480,American Masters: Miles Davis: Birth of the Cool,984499,614201,370298,2019.csv,2019,62.38716342017615,37.61283657982385
3481,Being Flynn,983124,540152,442972,2012.csv,2012,54.94240807873676,45.05759192126324
3482,Schindler's List 2018 Re-release,981489,833050,148439,2018.csv,2018,84.87614226955166,15.123857730448329
3483,Mr. Pip,977855,1714,976141,2013.csv,2013,0.17528161128183625,99.82471838871815
3484,Stuck in Love.,977671,81071,896600,2013.csv,2013,8.292257824973841,91.70774217502617
3485,Journey's End,970809,161796,809013,2018.csv,2018,16.6661001288616,83.3338998711384
3486,The Irishman,968853,0,968853,2019.csv,2019,0.0,100.0
3487,Trishna,967672,240381,727291,2012.csv,2012,24.84116518820427,75.15883481179573
3488,Ryuichi Sakamoto: Coda,962850,117460,845390,2018.csv,2018,12.199200290803343,87.80079970919665
3489,Rush: Cinema Strangiato 2019,960073,960073,0,2019.csv,2019,100.0,0.0
3490,A Prayer Before Dawn,958883,14453,944430,2018.csv,2018,1.5072746101453462,98.49272538985466
3491,The Endless,956425,272020,684405,2018.csv,2018,28.441330998248688,71.55866900175131
3492,The Fighting Preacher,954641,954641,0,2019.csv,2019,100.0,0.0
3493,The Catcher Was a Spy,953953,725223,228730,2018.csv,2018,76.02292775430236,23.977072245697638
3494,The Farewell Party,951531,172860,778671,2015.csv,2015,18.166512704262917,81.83348729573709
3495,Gimme Danger,950040,440627,509413,2016.csv,2016,46.37983663845733,53.62016336154267
3496,Under the Tree,944991,67596,877395,2017.csv,2017,7.153083997625374,92.84691600237463
3497,The Dinner,944808,7282,937526,2014.csv,2014,0.7707386050922516,99.22926139490775
3498,Rebel in the Rye,944370,378294,566076,2017.csv,2017,40.05781632199244,59.94218367800757
3499,Dark Horse 2016 Re-release,944061,940715,3346,2016.csv,2016,99.64557375000133,0.35442624999867595
3500,Afterimage,943029,33443,909586,2017.csv,2017,3.5463384477041533,96.45366155229584
3501,The Road,942041,92476,849565,2011.csv,2011,9.81655787805414,90.18344212194586
3502,Landline,940854,940854,0,2017.csv,2017,100.0,0.0
3503,Becoming Astrid,938766,120486,818280,2018.csv,2018,12.834508280018664,87.16549171998133
3504,Revenge,938055,102091,835964,2018.csv,2018,10.883263774512155,89.11673622548784
3505,The Vigil,935484,0,935484,2020.csv,2020,0.0,100.0
3506,Kaili Blues,935236,32164,903072,2016.csv,2016,3.4391319410287884,96.56086805897121
3507,Barely Lethal,933847,6075,927772,2015.csv,2015,0.6505348306521305,99.34946516934787
3508,Perfect Sense,933352,2959,930393,2011.csv,2011,0.31702937369824036,99.68297062630175
3509,A Borrowed Identity,930958,281540,649418,2015.csv,2015,30.241965802968558,69.75803419703145
3510,White Christmas 2018 Re-release,928298,928298,0,2018.csv,2018,100.0,0.0
3511,Like Arrows,928265,817990,110275,2018.csv,2018,88.12031047168642,11.879689528313573
3512,Toni Morrison: The Pieces I Am,927495,903018,24477,2019.csv,2019,97.36095612375269,2.6390438762473116
3513,How I Live Now,925762,60213,865549,2013.csv,2013,6.504155495688957,93.49584450431104
3514,Patterns of Evidence: Exodus,925576,925576,0,2015.csv,2015,100.0,0.0
3515,Gentleman,923884,897876,26008,2016.csv,2016,97.18492797797126,2.8150720220287395
3516,ATM,921752,3010,918742,2012.csv,2012,0.3265520443676824,99.67344795563233
3517,Paradise,921242,14873,906369,2017.csv,2017,1.6144509260324649,98.38554907396754
3518,Riverdance 25th Anniversary Show,920607,81879,838728,2020.csv,2020,8.894023182530656,91.10597681746935
3519,Palo Alto,919591,767732,151859,2014.csv,2014,83.48624551566947,16.513754484330534
3520,Back to 1942,918487,312954,605533,2012.csv,2012,34.07277402946367,65.92722597053633
3521,Kirk Cameron: Connect,918127,918127,0,2018.csv,2018,100.0,0.0
3522,The Lodgers,916727,7362,909365,2018.csv,2018,0.8030744158293581,99.19692558417064
3523,Kings,910269,274635,635634,2018.csv,2018,30.170751722842372,69.82924827715763
3524,Seymour: An Introduction,907742,743541,164201,2015.csv,2015,81.91104961541936,18.08895038458064
3525,Sholem Aleichem: Laughing in the Darkness,906666,906666,0,2011.csv,2011,100.0,0.0
3526,The Dead Lands,906158,5240,900918,2014.csv,2014,0.5782656004802694,99.42173439951974
3527,Bitter Harvest,904399,557241,347158,2017.csv,2017,61.61450864054472,38.38549135945529
3528,Generation Iron,901649,849521,52128,2013.csv,2013,94.21859282270594,5.781407177294047
3529,The Wildest Dream,898137,898137,0,2010.csv,2010,100.0,0.0
3530,The Game Changers,897992,739711,158281,2019.csv,2019,82.37389642669423,17.626103573305777
3531,The Disappearance of Alice Creed,896919,166980,729939,2010.csv,2010,18.61706575510163,81.38293424489837
3532,A Woman's Life,895944,37626,858318,2016.csv,2016,4.199592831694838,95.80040716830516
3533,You're Not You,894964,11486,883478,2014.csv,2014,1.2834035782444881,98.71659642175551
3534,Best of Enemies: Buckley vs. Vidal,892802,892802,0,2015.csv,2015,100.0,0.0
3535,Believe,890303,890303,0,2016.csv,2016,100.0,0.0
3536,Mafia Inc,889863,889863,0,2020.csv,2020,100.0,0.0
3537,Alone Yet Not Alone,887851,887851,0,2013.csv,2013,100.0,0.0
3538,The Future,887172,568662,318510,2011.csv,2011,64.09828082942202,35.90171917057797
3539,The Nightingale,885916,400209,485707,2019.csv,2019,45.17459894617548,54.82540105382452
3540,Always Kabhi Kabhi,884624,21381,863243,2011.csv,2011,2.4169590696160177,97.58304093038397
3541,Princess Kaiulani,883887,883887,0,2010.csv,2010,100.0,0.0
3542,Ai Weiwei: Never Sorry,881661,534100,347561,2012.csv,2012,60.57883925908031,39.421160740919696
3543,The Hummingbird Project,876980,371784,505196,2019.csv,2019,42.3936691828776,57.6063308171224
3544,Between Me and My Mind,875191,875191,0,2019.csv,2019,100.0,0.0
3545,The Polar Express 2017 IMAX Release,875150,875150,0,2017.csv,2017,100.0,0.0
3546,Particle Fever,869838,869838,0,2014.csv,2014,100.0,0.0
3547,Bird People,866211,32111,834100,2014.csv,2014,3.7070644450370636,96.29293555496294
3548,Howl's Moving Castle 2019 Re-release,865647,865647,0,2019.csv,2019,100.0,0.0
3549,Great Performances at the Met: Nico Muhly: Marnie,865551,849710,15841,2018.csv,2018,98.1698363239139,1.8301636760861002
3550,Cut Throat City,864928,855894,9034,2020.csv,2020,98.95551999704023,1.0444800029597838
3551,Brave,861630,527193,334437,2010.csv,2010,61.18554367884127,38.81445632115874
3552,Love,861057,249083,611974,2015.csv,2015,28.92758551408327,71.07241448591672
3553,Highway,858783,529136,329647,2014.csv,2014,61.61463373168775,38.38536626831225
3554,Night Moves,858513,271755,586758,2014.csv,2014,31.65415083988245,68.34584916011755
3555,Steel Magnolias 2019 Re-release,855421,855421,0,2019.csv,2019,100.0,0.0
3556,Chain Letter,855185,138788,716397,2010.csv,2010,16.229003081204652,83.77099691879535
3557,A Touch of Sin,854891,154120,700771,2013.csv,2013,18.02802930432067,81.97197069567933
3558,Happythankyoumoreplease,853862,216110,637752,2011.csv,2011,25.309710468436354,74.69028953156365
3559,The Sea of Trees,850985,20444,830541,2016.csv,2016,2.402392521607314,97.59760747839269
3560,31,850419,779820,70599,2016.csv,2016,91.69832753031153,8.301672469688471
3561,Wilson,848646,653951,194695,2017.csv,2017,77.05816088215816,22.941839117841834
3562,Atlas Shrugged: Who Is John Galt?,846704,846704,0,2014.csv,2014,100.0,0.0
3563,The Polar Express 2015 IMAX Release,846602,846602,0,2015.csv,2015,100.0,0.0
3564,Lizzie,844786,642157,202629,2018.csv,2018,76.01416216651317,23.985837833486823
3565,Heartbeats,843423,68723,774700,2010.csv,2010,8.14810599189256,91.85189400810744
3566,Higher Ground 2011 Re-release,843370,841733,1637,2011.csv,2011,99.80589776729076,0.1941022327092498
3567,Gunday,843232,0,843232,2014.csv,2014,0.0,100.0
3568,Mary Kom,839840,621300,218540,2014.csv,2014,73.9783768336826,26.021623166317394
3569,BANDSTAND: The Broadway Musical on Screen,839554,839554,0,2018.csv,2018,100.0,0.0
3570,Hôtel Normandy,836709,4640,832069,2013.csv,2013,0.5545536142195195,99.44544638578049
3571,Khiladi 786,835095,379466,455629,2012.csv,2012,45.439860135673186,54.560139864326814
3572,The Exception,834572,708973,125599,2017.csv,2017,84.95048959227005,15.049510407729949
3573,Premam,834525,828278,6247,2016.csv,2016,99.25143045445014,0.7485695455498637
3574,Children's Party,832150,6330,825820,2011.csv,2011,0.7606801658354864,99.23931983416452
3575,Byzantium,828284,89237,739047,2013.csv,2013,10.773720124981287,89.2262798750187
3576,Detective Byomkesh Bakshy!,827437,579055,248382,2015.csv,2015,69.98176296201403,30.018237037985973
3577,13 Sins,826913,13809,813104,2014.csv,2014,1.669945931434141,98.33005406856586
3578,Gekijouban K: Missing Kings,826323,33531,792792,2014.csv,2014,4.057856310425826,95.94214368957418
3579,Inside,824414,0,824414,2017.csv,2017,0.0,100.0
3580,Que Leones,822828,822828,0,2019.csv,2019,100.0,0.0
3581,The Nest,820520,137886,682634,2020.csv,2020,16.804709208794424,83.19529079120558
3582,The Lord of the Rings: The Return of the King 2011 Re-release,818580,818580,0,2011.csv,2011,100.0,0.0
3583,Babyteeth,817712,4507,813205,2020.csv,2020,0.5511720507953901,99.44882794920461
3584,Possessor,816145,752885,63260,2020.csv,2020,92.24892635499819,7.751073645001807
3585,Life Itself,815645,810454,5191,2014.csv,2014,99.36357116147343,0.6364288385265648
3586,Saw 10th Anniversary Release,815324,815324,0,2014.csv,2014,100.0,0.0
3587,What If...,814906,814906,0,2010.csv,2010,100.0,0.0
3588,Tangerine,814868,702354,112514,2015.csv,2015,86.1923648983639,13.807635101636093
3589,Age of Uprising: The Legend of Michael Kohlhaas,813550,3313,810237,2013.csv,2013,0.4072275828160531,99.59277241718395
3590,The Heiresses,811196,78473,732723,2018.csv,2018,9.67374099477808,90.32625900522191
3591,Bangistan,810419,48694,761725,2015.csv,2015,6.008496839289306,93.99150316071069
3592,Bill W.,809590,809590,0,2012.csv,2012,100.0,0.0
3593,Joni 75: A Birthday Celebration,808831,752205,56626,2019.csv,2019,92.99903193621411,7.0009680637858835
3594,The Whistlers,808743,55608,753135,2019.csv,2019,6.875855494267029,93.12414450573297
3595,Breathing,807436,4630,802806,2011.csv,2011,0.5734200605373058,99.42657993946268
3596,V/H/S/2,805574,21833,783741,2013.csv,2013,2.71024139309362,97.28975860690639
3597,The Tillman Story,802535,802535,0,2010.csv,2010,100.0,0.0
3598,The Wrecking Crew!,801606,801606,0,2015.csv,2015,100.0,0.0
3599,Red Army,798680,694600,104080,2015.csv,2015,86.96849802173587,13.031501978264135
3600,Wakefield,798214,262599,535615,2017.csv,2017,32.8983205005174,67.10167949948259
3601,Vita & Virginia,793439,42741,750698,2019.csv,2019,5.386803522387985,94.61319647761202
3602,Shortcut,793084,793084,0,2020.csv,2020,100.0,0.0
3603,Tickled,790519,613956,176563,2016.csv,2016,77.66492645970558,22.335073540294413
3604,Thin Ice,790421,790421,0,2012.csv,2012,100.0,0.0
3605,Lootera,789671,581813,207858,2013.csv,2013,73.67789877050063,26.322101229499374
3606,Momentum,789406,0,789406,2015.csv,2015,0.0,100.0
3607,Chonda Pierce: Unashamed,787979,787979,0,2019.csv,2019,100.0,0.0
3608,Elf 2019 Re-release,786249,786249,0,2019.csv,2019,100.0,0.0
3609,George Takei's Allegiance,784850,784850,0,2017.csv,2017,100.0,0.0
3610,Life During Wartime,783232,281447,501785,2010.csv,2010,35.93405274554666,64.06594725445333
3611,The Paris Opera,781039,55482,725557,2017.csv,2017,7.103614544216103,92.8963854557839
3612,Futuro Beach,779835,20262,759573,2014.csv,2014,2.5982419357941104,97.4017580642059
3613,Mrs. Hyde,778142,18627,759515,2018.csv,2018,2.393779027478275,97.60622097252173
3614,Enter the Void,775385,336467,438918,2010.csv,2010,43.393539983363105,56.606460016636895
3615,Ordinary Love,774877,323688,451189,2019.csv,2019,41.77282329969788,58.22717670030211
3616,The D Train,774780,673151,101629,2015.csv,2015,86.8828570691035,13.117142930896513
3617,The Church,772000,772000,0,2019.csv,2019,100.0,0.0
3618,Grand Masti,770535,413903,356632,2013.csv,2013,53.716313989630585,46.283686010369415
3619,Pariah,769552,769552,0,2011.csv,2011,100.0,0.0
3620,The Lord of the Rings: The Fellowship of the Ring 2011 Re-release,768580,768580,0,2011.csv,2011,100.0,0.0
3621,Theeb,768449,283024,485425,2015.csv,2015,36.83055088886836,63.16944911113165
3622,Yalom's Cure,766974,1164,765810,2014.csv,2014,0.15176524888718523,99.84823475111281
3623,Lo and Behold: Reveries of the Connected World,765796,594912,170884,2016.csv,2016,77.68544103129294,22.314558968707072
3624,DanTDM Presents The Contest,765363,307484,457879,2019.csv,2019,40.17492353301636,59.82507646698364
3625,Patterns of Evidence: Moses Controversy,765361,765361,0,2019.csv,2019,100.0,0.0
3626,The Polar Express 2016 IMAX Release,765154,765154,0,2016.csv,2016,100.0,0.0
3627,The Lord of the Rings: The Two Towers 2011 Re-release,764607,764607,0,2011.csv,2011,100.0,0.0
3628,Kahlil Gibran's The Prophet,764498,355343,409155,2015.csv,2015,46.48056633241683,53.51943366758317
3629,The Invisibles,764250,407373,356877,2018.csv,2018,53.303631010794895,46.6963689892051
3630,Pick of the Litter,763688,578717,184971,2018.csv,2018,75.77924492724777,24.220755072752223
3631,Museo,762284,148505,613779,2018.csv,2018,19.481584291418947,80.51841570858106
3632,The Shining 2017 Re-release,760309,421572,338737,2017.csv,2017,55.44745623161109,44.5525437683889
3633,Bombay Velvet,758478,450692,307786,2015.csv,2015,59.420576470247,40.57942352975301
3634,Jaws 2020 Re-release,758367,758300,67,2020.csv,2020,99.9911652273899,0.008834772610095113
3635,Boundaries,755977,703438,52539,2018.csv,2018,93.05018538923802,6.949814610761967
3636,I Love Lucy: A Colorized Celebration,754323,754323,0,2019.csv,2019,100.0,0.0
3637,Middle Men,754301,754301,0,2010.csv,2010,100.0,0.0
3638,Elsa & Fred,753975,285863,468112,2014.csv,2014,37.914121821015286,62.08587817898471
3639,Tommy's Honour,751345,569306,182039,2017.csv,2017,75.77158296122288,24.228417038777124
3640,A Five Star Life 2014 Re-release,749653,306917,442736,2014.csv,2014,40.94120879927113,59.05879120072887
3641,Everybody's Everything,748539,547207,201332,2019.csv,2019,73.1033386369982,26.896661363001794
3642,Hobo with a Shotgun,748453,703372,45081,2011.csv,2011,93.97677609682906,6.0232239031709405
3643,Arthur Newman,747140,207853,539287,2013.csv,2013,27.819819578659953,72.18018042134004
3644,Holy Rollers,744266,303064,441202,2010.csv,2010,40.719850161098314,59.280149838901686
3645,Saturday's Warrior,744046,744046,0,2016.csv,2016,100.0,0.0
3646,Palm Springs,741554,164000,577554,2020.csv,2020,22.115719151943082,77.88428084805692
3647,"Kumiko, The Treasure Hunter",739623,623383,116240,2015.csv,2015,84.28388516852505,15.716114831474954
3648,Forks Over Knives,739561,739561,0,2011.csv,2011,100.0,0.0
3649,Vicky Donor,739085,549001,190084,2012.csv,2012,74.28117198968995,25.718828010310048
3650,Ramen Shop,735008,88455,646553,2018.csv,2018,12.034562889111411,87.96543711088859
3651,Wiener-Dog,734729,477453,257276,2016.csv,2016,64.98355175853955,35.01644824146046
3652,David Crosby: Remember My Name,732793,732793,0,2019.csv,2019,100.0,0.0
3653,Once I Was a Beehive,732655,732655,0,2015.csv,2015,100.0,0.0
3654,Tabloid,731925,696921,35004,2011.csv,2011,95.21754278102264,4.782457218977354
3655,The Polar Express 2018 Re-release,731018,731018,0,2018.csv,2018,100.0,0.0
3656,Slaughterhouse Rulez,730762,4665,726097,2018.csv,2018,0.6383747376026667,99.36162526239734
3657,How I Ended This Summer,730412,8733,721679,2010.csv,2010,1.1956265778765958,98.8043734221234
3658,Land Ho!,727594,727594,0,2014.csv,2014,100.0,0.0
3659,Peggy Guggenheim: Art Addict,727591,498428,229163,2015.csv,2015,68.50387099345649,31.496129006543512
3660,Toy Story 2020 Re-release,727218,727000,218,2020.csv,2020,99.9700227442115,0.029977255788498084
3661,Liz and the Blue Bird,726454,63204,663250,2018.csv,2018,8.700344412722623,91.29965558727737
3662,"Monsters, Inc. 2020 Re-release",726000,726000,0,2020.csv,2020,100.0,0.0
3663,Bullett Raja,725588,0,725588,2013.csv,2013,0.0,100.0
3664,The Great Alaskan Race,725415,485603,239812,2019.csv,2019,66.94140595383332,33.058594046166675
3665,May It Last,725286,725286,0,2017.csv,2017,100.0,0.0
3666,A Tale of Love and Darkness,724885,572212,152673,2015.csv,2015,78.93831435331121,21.061685646688787
3667,The Act of Killing,722714,486919,235795,2013.csv,2013,67.37367755432993,32.62632244567007
3668,Where's My Roy Cohn?,722603,705274,17329,2019.csv,2019,97.60186437089246,2.398135629107546
3669,Singham,722451,350864,371587,2011.csv,2011,48.56578508438635,51.43421491561365
3670,12 Days,722049,5204,716845,2017.csv,2017,0.7207267096831379,99.27927329031687
3671,Effie Gray,721143,352534,368609,2014.csv,2014,48.88544990383322,51.11455009616678
3672,Kusama: Infinity,720480,360931,359549,2018.csv,2018,50.09590828336664,49.90409171663335
3673,Revive Us 2,718607,718607,0,2017.csv,2017,100.0,0.0
3674,2001: A Space Odyssey 2014 Re-release,717744,214618,503126,2014.csv,2014,29.9017476983437,70.0982523016563
3675,The Shining 2012 Re-release,715736,342749,372987,2012.csv,2012,47.88762895816335,52.11237104183666
3676,Passion,713616,92181,621435,2013.csv,2013,12.917451402434924,87.08254859756508
3677,Gerhard Richter Painting,713188,242646,470542,2011.csv,2011,34.022726125509685,65.97727387449032
3678,The Addams Family 2020 Re-release,711543,678926,32617,2020.csv,2020,95.41601842755813,4.583981572441862
3679,Shootout at Wadala,711366,369573,341793,2013.csv,2013,51.95258137161461,48.04741862838539
3680,The Polar Express 2011 IMAX Release,711168,711168,0,2011.csv,2011,100.0,0.0
3681,Extraction,710636,16775,693861,2015.csv,2015,2.3605615251690035,97.639438474831
3682,Muscle Shoals,709415,696241,13174,2013.csv,2013,98.14297695988948,1.8570230401105134
3683,Paris Countdown,708757,1055,707702,2013.csv,2013,0.14885214537563649,99.85114785462437
3684,Gori Tere Pyaar Mein!,708440,342184,366256,2013.csv,2013,48.301055841002764,51.69894415899723
3685,HBO Boxing: Canelo Alvarez vs. Gennady Golovkin II,707875,707875,0,2018.csv,2018,100.0,0.0
3686,Passione,707460,255355,452105,2010.csv,2010,36.09462019054081,63.9053798094592
3687,The Lost Medallion: The Adventures of Billy Stone,705854,549632,156222,2013.csv,2013,77.86766101771755,22.132338982282455
3688,Itzhak,704968,607290,97678,2018.csv,2018,86.14433562941865,13.85566437058136
3689,Blaze,704955,704955,0,2018.csv,2018,100.0,0.0
3690,The Shining 2019 Re-release,704716,551257,153459,2019.csv,2019,78.22399377905425,21.776006220945742
3691,Countdown to Canelo vs. Golovkin,703396,703396,0,2017.csv,2017,100.0,0.0
3692,Buena Vista Social Club: Adios,701575,123445,578130,2017.csv,2017,17.595410326764778,82.40458967323522
3693,Le Quattro Volte,701334,152530,548804,2010.csv,2010,21.74855347095678,78.25144652904322
3694,56 Up,701278,701278,0,2013.csv,2013,100.0,0.0
3695,Our Children,700215,23203,677012,2012.csv,2012,3.3136965075012674,96.68630349249874
3696,The Greatest Movie Ever Sold,698249,638476,59773,2011.csv,2011,91.4395867376824,8.560413262317597
3697,The Shining 40th Anniversary,696858,0,696858,2020.csv,2020,0.0,100.0
3698,Patterns of Evidence: The Red Sea Miracle,696191,696191,0,2020.csv,2020,100.0,0.0
3699,Frankie & Alice 2014 Re-release,695876,695876,0,2014.csv,2014,100.0,0.0
3700,Frankie,695680,171781,523899,2019.csv,2019,24.69253104875805,75.30746895124196
3701,Raise Hell: The Life & Times of Molly Ivins,695327,694410,917,2019.csv,2019,99.86811960415747,0.13188039584253164
3702,The Least of These: The Graham Staines Story,695164,607015,88149,2019.csv,2019,87.31968283743117,12.680317162568834
3703,The Congress 2013 Re-release,695131,137815,557316,2013.csv,2013,19.82575946116631,80.17424053883369
3704,Jim Henson's Holiday Special with Fraggle Rock and Emmet Otter,695130,695130,0,2018.csv,2018,100.0,0.0
3705,The Secret Scripture,694981,0,694981,2017.csv,2017,0.0,100.0
3706,In the Aisles,694586,28394,666192,2018.csv,2018,4.087902721909166,95.91209727809084
3707,Chris Brown: Welcome To My Life,693984,693984,0,2017.csv,2017,100.0,0.0
3708,Titanic 2017 Re-release,693626,691642,1984,2017.csv,2017,99.7139668928212,0.28603310717879665
3709,Ferrari Ki Sawaari,689861,434107,255754,2012.csv,2012,62.92673451608367,37.07326548391632
3710,Romeo Akbar Walter,688719,236299,452420,2019.csv,2019,34.309929013138884,65.69007098686112
3711,Cobain: Montage of Heck,687649,0,687649,2015.csv,2015,0.0,100.0
3712,Vettai,687636,204373,483263,2012.csv,2012,29.721102443734765,70.27889755626524
3713,Mr. Church,685780,685780,0,2016.csv,2016,100.0,0.0
3714,Bethany Hamilton: Unstoppable,684078,590671,93407,2019.csv,2019,86.34556293288192,13.654437067118078
3715,Brigsby Bear,681632,532669,148963,2017.csv,2017,78.14612576874325,21.853874231256746
3716,"Right Now, Wrong Then",680728,24470,656258,2015.csv,2015,3.5946809885886872,96.40531901141132
3717,3 Generations,680351,155936,524415,2016.csv,2016,22.91993397525689,77.0800660247431
3718,A Matter of Faith,680113,680113,0,2014.csv,2014,100.0,0.0
3719,I Spit on Your Grave 2,678604,809,677795,2013.csv,2013,0.11921533029572474,99.88078466970427
3720,All I See Is You,678150,217644,460506,2017.csv,2017,32.09378456093784,67.90621543906215
3721,Baaghi,676602,438207,238395,2016.csv,2016,64.76584461766296,35.23415538233703
3722,Tyrannosaur,676111,22321,653790,2011.csv,2011,3.3013809862581733,96.69861901374183
3723,5 to 7,674579,162685,511894,2015.csv,2015,24.11652304622587,75.88347695377414
3724,Beyond the Hills,673493,124919,548574,2012.csv,2012,18.54792848626489,81.45207151373512
3725,The Trump Prophecy,671198,671198,0,2018.csv,2018,100.0,0.0
3726,Anna and the Apocalypse,670430,545597,124833,2018.csv,2018,81.38015900243127,18.619840997568723
3727,The Polar Express 2012 IMAX Release,669289,669289,0,2012.csv,2012,100.0,0.0
3728,Bright Days Ahead 2013 Re-release,669085,21770,647315,2013.csv,2013,3.253697213358542,96.74630278664146
3729,The Torn Poster Let Out a Hero,669070,410526,258544,2013.csv,2013,61.357705471774246,38.64229452822575
3730,Tai Chi 2: The Hero Rises,668484,35067,633417,2012.csv,2012,5.245750085267561,94.75424991473244
3731,Girlfriend Boyfriend,667626,64414,603212,2012.csv,2012,9.648216216863933,90.35178378313606
3732,A Bottle in the Gaza Sea,666011,5872,660139,2012.csv,2012,0.8816671196121385,99.11833288038785
3733,Mr. Gaga: A True Story of Love and Dance,665617,173994,491623,2016.csv,2016,26.14025783596272,73.85974216403727
3734,Stockholm,665527,292590,372937,2019.csv,2019,43.963655869709264,56.03634413029073
3735,The Stanford Prison Experiment,663114,660561,2553,2015.csv,2015,99.61499832607967,0.38500167392032136
3736,City of Gold,660445,640979,19466,2016.csv,2016,97.05259332722635,2.94740667277366
3737,Camille Claudel 1915,660355,35296,625059,2013.csv,2013,5.345003823700888,94.65499617629911
3738,Another Happy Day,659937,8464,651473,2011.csv,2011,1.282546667333397,98.71745333266661
3739,The Woman in the Fifth,659769,113800,545969,2011.csv,2011,17.24846120384559,82.7515387961544
3740,Dragon Ball Z: Broly - The Legendary Super Saiyan,658982,658982,0,2018.csv,2018,100.0,0.0
3741,Madame Bovary,658532,44235,614297,2015.csv,2015,6.717213438375053,93.28278656162496
3742,The Painted Bird,657261,1460,655801,2019.csv,2019,0.22213397721757414,99.77786602278242
3743,Black Water: Abyss,656976,0,656976,2020.csv,2020,0.0,100.0
3744,Terri,655802,655802,0,2011.csv,2011,100.0,0.0
3745,The Patience Stone,654587,148671,505916,2013.csv,2013,22.712183407247625,77.28781659275238
3746,No Problem,654369,285468,368901,2010.csv,2010,43.62492721996305,56.37507278003695
3747,Whisky Galore,653866,20991,632875,2017.csv,2017,3.2102907935265024,96.78970920647349
3748,Ponyo 2018 Re-release,653072,653072,0,2018.csv,2018,100.0,0.0
3749,Rascals,652756,273829,378927,2011.csv,2011,41.94967185288224,58.05032814711776
3750,In Secret,652228,444179,208049,2013.csv,2013,68.10179875748972,31.89820124251029
3751,Salinger,650675,583633,67042,2013.csv,2013,89.69654589464785,10.303454105352134
3752,The Extra Man,649626,453377,196249,2010.csv,2010,69.79046405162354,30.20953594837645
3753,The Family Fang,649555,262921,386634,2016.csv,2016,40.477095857933506,59.522904142066494
3754,Jodorowsky's Dune,647280,647280,0,2014.csv,2014,100.0,0.0
3755,Storage 24,646175,72,646103,2012.csv,2012,0.01114249235888111,99.98885750764111
3756,The Public,644740,573503,71237,2019.csv,2019,88.95105003567329,11.048949964326706
3757,Dracula 3D,643758,8139,635619,2012.csv,2012,1.2642949679848638,98.73570503201513
3758,Love and Honor,641929,19684,622245,2012.csv,2012,3.0663827308004468,96.93361726919956
3759,Marjaavaan,641154,174164,466990,2019.csv,2019,27.16414465167495,72.83585534832505
3760,Museum Hours,639121,561457,77664,2012.csv,2012,87.848310413834,12.151689586165999
3761,Aquarela,638907,307346,331561,2019.csv,2019,48.10496676355088,51.89503323644913
3762,Jack Goes Boating,637479,541992,95487,2010.csv,2010,85.02115363800219,14.978846361997809
3763,Welcome to Me,636819,608852,27967,2015.csv,2015,95.60832826910001,4.391671730899989
3764,The Virginity Hit,636706,636706,0,2010.csv,2010,100.0,0.0
3765,Not Fade Away,636399,610792,25607,2012.csv,2012,95.97626646176377,4.0237335382362325
3766,Batti Gul Meter Chalu,635869,249539,386330,2018.csv,2018,39.243775054295774,60.75622494570423
3767,The Last Lions,635325,635325,0,2011.csv,2011,100.0,0.0
3768,Kaboom,635162,118919,516243,2010.csv,2010,18.722625094070487,81.2773749059295
3769,The Burnt Orange Heresy,634806,144201,490605,2020.csv,2020,22.715758830256803,77.2842411697432
3770,A Beautiful Life,634784,66171,568613,2011.csv,2011,10.42417578262842,89.57582421737158
3771,No One Killed Jessica,634297,440525,193772,2011.csv,2011,69.45090391409703,30.549096085902978
3772,The Black Prince,632823,0,632823,2017.csv,2017,0.0,100.0
3773,Grace Jones: Bloodlight and Bami,632394,375208,257186,2017.csv,2017,59.33136620524546,40.66863379475454
3774,Jonah: The Musical,631154,631154,0,2017.csv,2017,100.0,0.0
3775,Mermaid in Paris,630987,1988,628999,2020.csv,2020,0.3150619584872589,99.68493804151274
3776,Shut Up and Play the Hits,629107,510334,118773,2012.csv,2012,81.12038174746108,18.879618252538915
3777,Short Peace,628807,22862,605945,2013.csv,2013,3.6357737747830416,96.36422622521695
3778,Asako I & II,627102,25559,601543,2019.csv,2019,4.07573249646788,95.92426750353212
3779,Korkoro,627088,8242,618846,2010.csv,2010,1.3143290893782054,98.6856709106218
3780,I'm Still Here,626396,408983,217413,2010.csv,2010,65.2914450283846,34.7085549716154
3781,"Love, Gilda",626318,626318,0,2018.csv,2018,100.0,0.0
3782,Sleepless Night,624913,3358,621555,2011.csv,2011,0.5373547997881305,99.46264520021188
3783,Give Me Liberty,624818,242734,382084,2019.csv,2019,38.84875275680278,61.15124724319722
3784,The Sound of Music 2018 Re-release,624392,616171,8221,2018.csv,2018,98.68335917180234,1.3166408281976707
3785,Winter in Wartime 2010 Re-release,623392,543100,80292,2010.csv,2010,87.12014270314666,12.879857296853345
3786,Nancy Drew and the Hidden Staircase,623088,623088,0,2019.csv,2019,100.0,0.0
3787,Dirty Dancing 2019 Re-release,622968,622968,0,2019.csv,2019,100.0,0.0
3788,Range 15,621738,621738,0,2016.csv,2016,100.0,0.0
3789,Ghostbusters 2020 Re-release,620883,605000,15883,2020.csv,2020,97.4418690800038,2.5581309199961986
3790,Die Hard 30th Anniversary Release,620525,510241,110284,2018.csv,2018,82.2273075218565,17.772692478143508
3791,"Happy, Happy",620238,45154,575084,2010.csv,2010,7.280108603471571,92.71989139652842
3792,Killerman,619855,291477,328378,2019.csv,2019,47.0234167668245,52.9765832331755
3793,The Transformers,619597,619597,0,2018.csv,2018,100.0,0.0
3794,Nowitzki: The Perfect Shot,619517,41340,578177,2014.csv,2014,6.672940371289246,93.32705962871076
3795,Paradise: Faith,618696,6508,612188,2013.csv,2013,1.0518897810879657,98.94811021891203
3796,Paulo Coelho's Best Story,617377,8808,608569,2014.csv,2014,1.4266809421147857,98.57331905788521
3797,The Bronze,615816,615816,0,2016.csv,2016,100.0,0.0
3798,Lost River,615500,45431,570069,2015.csv,2015,7.381153533712428,92.61884646628758
3799,"A White, White Day",614674,0,614674,2019.csv,2019,0.0,100.0
3800,Omar,614444,356000,258444,2013.csv,2013,57.938559087565345,42.061440912434655
3801,Synchronic,613405,613405,0,2020.csv,2020,100.0,0.0
3802,Walking the Camino: Six Ways to Santiago,612717,612717,0,2013.csv,2013,100.0,0.0
3803,The Returned,612521,0,612521,2013.csv,2013,0.0,100.0
3804,In Another Country,611365,25079,586286,2012.csv,2012,4.102132114203463,95.89786788579654
3805,True to the Game 2,610710,610710,0,2020.csv,2020,100.0,0.0
3806,The Muppet Movie 2019 Re-release,610475,610475,0,2019.csv,2019,100.0,0.0
3807,Project Nim,609880,411184,198696,2011.csv,2011,67.42047615924444,32.579523840755556
3808,Alone,609543,537589,71954,2020.csv,2020,88.19541853486956,11.804581465130434
3809,Dead Before Dawn 3D,608881,0,608881,2012.csv,2012,0.0,100.0
3810,The Last Suit,608209,73548,534661,2017.csv,2017,12.092553710977642,87.90744628902236
3811,Mr. Right,607595,34694,572901,2016.csv,2016,5.71005357186942,94.28994642813058
3812,The Reports on Sarah and Saleem,607206,117479,489727,2018.csv,2018,19.347470216038708,80.65252978396128
3813,Life in a Day,607169,252788,354381,2011.csv,2011,41.63387788243471,58.36612211756529
3814,Bolshoi Ballet: The Sleeping Beauty,606872,311368,295504,2019.csv,2019,51.3070301480378,48.69296985196219
3815,Neither Wolf Nor Dog,606511,606511,0,2017.csv,2017,100.0,0.0
3816,The Walking Dead: Wrath/The Walking Dead/Fear the Walking Dead: What's Your Story?/Fear the Walking Dead,605764,605764,0,2018.csv,2018,100.0,0.0
3817,Summer in February,605403,1624,603779,2013.csv,2013,0.26825106581896685,99.73174893418103
3818,The Golden Glove,604479,6160,598319,2019.csv,2019,1.0190593883327626,98.98094061166724
3819,"DCI 2019: Big, Loud & Live 16",603320,603320,0,2018.csv,2018,100.0,0.0
3820,Undertow,602059,108620,493439,2010.csv,2010,18.04142118961763,81.95857881038238
3821,The Little Death,601162,18238,582924,2014.csv,2014,3.0337912243288834,96.96620877567112
3822,The Grateful Dead Meet-Up 2018,600554,600554,0,2018.csv,2018,100.0,0.0
3823,Oh Lucy!,600145,375391,224754,2018.csv,2018,62.55005040448558,37.44994959551441
3824,Jimi: All Is by My Side,599840,340911,258929,2014.csv,2014,56.8336556415044,43.1663443584956
3825,The Fencer 2016 Re-release,599537,95952,503585,2016.csv,2016,16.00435002343475,83.99564997656525
3826,The One I Love,596933,513447,83486,2014.csv,2014,86.0141757952735,13.985824204726494
3827,Stevie Nicks 24 Karat Gold the Concert,596905,410265,186640,2020.csv,2020,68.73204278737822,31.267957212621774
3828,Trust,595802,120016,475786,2011.csv,2011,20.143604754599682,79.85639524540031
3829,Skin Trade,595268,1242,594026,2015.csv,2015,0.2086455176491933,99.7913544823508
3830,Blue Like Jazz,595018,595018,0,2012.csv,2012,100.0,0.0
3831,Ixcanul,594836,295157,299679,2015.csv,2015,49.61989523162687,50.38010476837314
3832,Are You Here,594396,0,594396,2014.csv,2014,0.0,100.0
3833,The Armstrong Lie,594394,383294,211100,2013.csv,2013,64.4848366571668,35.515163342833205
3834,Boss,594283,0,594283,2013.csv,2013,0.0,100.0
3835,The Big Lebowski 2018 Re-release,592832,582585,10247,2018.csv,2018,98.27151705710892,1.7284829428910722
3836,The Climb,592461,143423,449038,2020.csv,2020,24.208006940541235,75.79199305945876
3837,To Kill a Mockingbird 2019 Re-release,592237,592237,0,2019.csv,2019,100.0,0.0
3838,Compliance,592116,319285,272831,2012.csv,2012,53.92271109039445,46.07728890960555
3839,The Cure: Anniversary 1978-2018 Live in Hyde Park,591904,378405,213499,2019.csv,2019,63.93013056171271,36.06986943828729
3840,The Wonderland,591857,50876,540981,2019.csv,2019,8.595995316436234,91.40400468356377
3841,The Human Resources Manager,590567,64014,526553,2010.csv,2010,10.839413648239743,89.16058635176026
3842,Storm Surfers 3D,589945,117090,472855,2012.csv,2012,19.847612913068165,80.15238708693182
3843,Starry Starry Night,589299,10033,579266,2011.csv,2011,1.702531312627376,98.29746868737263
3844,Elvis on Tour,587818,587818,0,2010.csv,2010,100.0,0.0
3845,Thunderstruck,587211,587211,0,2012.csv,2012,100.0,0.0
3846,Upstream Color,587174,444098,143076,2013.csv,2013,75.63311727017886,24.366882729821143
3847,Seberg,585845,434702,151143,2020.csv,2020,74.20085517500364,25.79914482499637
3848,The Black Panthers: Vanguard of the Revolution,584109,516893,67216,2015.csv,2015,88.4925587518768,11.50744124812321
3849,Undefeated,583844,562218,21626,2012.csv,2012,96.2959283644261,3.7040716355738863
3850,Gleason,583664,583664,0,2016.csv,2016,100.0,0.0
3851,The Flat,583443,471842,111601,2012.csv,2012,80.87199606473983,19.12800393526017
3852,White God,581904,282358,299546,2014.csv,2014,48.52312408919685,51.47687591080315
3853,Novitiate,580346,580346,0,2017.csv,2017,100.0,0.0
3854,Bedeviled,579942,0,579942,2017.csv,2017,0.0,100.0
3855,And Then We Danced,579574,177262,402312,2019.csv,2019,30.584877858565086,69.41512214143492
3856,Harry & Snowman,578820,561460,17360,2016.csv,2016,97.00079472029302,2.99920527970699
3857,Bilal: A New Breed of Hero 2018 Re-release,576805,490973,85832,2018.csv,2018,85.11940777212402,14.880592227875972
3858,Mesrine: Killer Instinct 2010 Re-release,572790,551697,21093,2010.csv,2010,96.31749855968155,3.682501440318441
3859,The Falling,569498,0,569498,2015.csv,2015,0.0,100.0
3860,Goodbye to Language,566423,401889,164534,2014.csv,2014,70.95209763727814,29.04790236272185
3861,Never Too Late,564892,0,564892,2020.csv,2020,0.0,100.0
3862,Margaret,564864,46495,518369,2011.csv,2011,8.231184851574893,91.7688151484251
3863,The Cat Returns 2018 Re-release,563718,563718,0,2018.csv,2018,100.0,0.0
3864,Like Someone in Love,562878,239056,323822,2012.csv,2012,42.47030439988772,57.529695600112284
3865,Beetlejuice 2018 Re-release,562613,512947,49666,2018.csv,2018,91.1722622833102,8.827737716689803
3866,The Happiest Day in the Life of Olli Maki,562537,0,562537,2016.csv,2016,0.0,100.0
3867,My Fair Lady 2019 Re-release,560711,560711,0,2019.csv,2019,100.0,0.0
3868,Fiddler: A Miracle of Miracles,558816,549386,9430,2019.csv,2019,98.31250357899559,1.6874964210044092
3869,The Dance of Reality,558636,293680,264956,2013.csv,2013,52.57090484680543,47.42909515319457
3870,Forrest Gump 2014 IMAX Release,557683,557683,0,2014.csv,2014,100.0,0.0
3871,Castle in the Sky 2018 Re-release,557541,523664,33877,2018.csv,2018,93.92385492726095,6.076145072739045
3872,Rojo,557092,94757,462335,2018.csv,2018,17.00921930309536,82.99078069690464
3873,Samaritan's Purse presents Facing Darkness,555533,555533,0,2017.csv,2017,100.0,0.0
3874,Circumstance,555511,454121,101390,2011.csv,2011,81.74833621656457,18.251663783435433
3875,Dolores,555309,555309,0,2017.csv,2017,100.0,0.0
3876,Every Thing Will Be Fine,554953,9233,545720,2015.csv,2015,1.6637444972817519,98.33625550271825
3877,Endless Poetry,554706,153440,401266,2016.csv,2016,27.66149996574762,72.33850003425239
3878,Viral,551760,0,551760,2016.csv,2016,0.0,100.0
3879,Open Windows,550108,1750,548358,2014.csv,2014,0.3181193511092367,99.68188064889077
3880,Black Panther 2020 Re-release,549774,367000,182774,2020.csv,2020,66.75470284153124,33.24529715846875
3881,Dhadak,549628,0,549628,2018.csv,2018,0.0,100.0
3882,23 Blast,549185,549185,0,2014.csv,2014,100.0,0.0
3883,Followed,548608,538179,10429,2020.csv,2020,98.09900694120391,1.9009930587960804
3884,We Are X,548126,45270,502856,2016.csv,2016,8.25904992647676,91.74095007352324
3885,Planetarium,546584,3262,543322,2016.csv,2016,0.5967975645097551,99.40320243549024
3886,A Girl Walks Home Alone at Night,546352,491910,54442,2014.csv,2014,90.03536181802208,9.96463818197792
3887,My Generation,546183,0,546183,2018.csv,2018,0.0,100.0
3888,Rudderless,546149,58293,487856,2014.csv,2014,10.673460905357329,89.32653909464267
3889,"DCI 2019: Big, Loud & Live 16",546060,546060,0,2019.csv,2019,100.0,0.0
3890,The Art of the Steal,544890,544890,0,2010.csv,2010,100.0,0.0
3891,He's Out There,544674,0,544674,2018.csv,2018,0.0,100.0
3892,The Day Shall Come,543993,26972,517021,2019.csv,2019,4.958152035044568,95.04184796495542
3893,Beauty and the Beast 2020 Re-release,543260,467000,76260,2020.csv,2020,85.96252254905569,14.0374774509443
3894,On Any Sunday: The Next Chapter,543044,543044,0,2014.csv,2014,100.0,0.0
3895,The Club,541515,52761,488754,2015.csv,2015,9.743220409406941,90.25677959059306
3896,Dragon Ball Z: Bardock - The Father of Goku/Dragon Ball Z: Fusion Reborn,540707,540707,0,2018.csv,2018,100.0,0.0
3897,On the Way to School 2015 Re-release,540658,7424,533234,2015.csv,2015,1.3731416163267722,98.62685838367324
3898,StarDog and TurboCat,537586,80490,457096,2019.csv,2019,14.97248812283058,85.02751187716942
3899,Grateful Dead Meet-Up 2019,537153,537153,0,2019.csv,2019,100.0,0.0
3900,CatVideoFest,536566,470923,65643,2019.csv,2019,87.76609028525849,12.233909714741523
3901,Once Were Brothers: Robbie Robertson and the Band,536534,449561,86973,2020.csv,2020,83.78984370049241,16.21015629950758
3902,Karwaan,536525,182009,354516,2018.csv,2018,33.92367550440334,66.07632449559667
3903,Hungry Hearts,534549,6921,527628,2015.csv,2015,1.2947363104224308,98.70526368957758
3904,What They Had,533579,260136,273443,2018.csv,2018,48.75304312950847,51.24695687049153
3905,Creature,533235,508714,24521,2011.csv,2011,95.40146464504393,4.59853535495607
3906,Kill Your Friends,533147,0,533147,2015.csv,2015,0.0,100.0
3907,Kahaani 2,532877,350703,182174,2016.csv,2016,65.81312385409767,34.18687614590234
3908,Standing Ovation,531806,531806,0,2010.csv,2010,100.0,0.0
3909,Metropolis 2010 Re-release,529603,529603,0,2010.csv,2010,100.0,0.0
3910,Margaret Atwood: Live in Cinemas,529285,93690,435595,2019.csv,2019,17.7012384632098,82.2987615367902
3911,The Call,527680,515831,11849,2020.csv,2020,97.75451030927836,2.2454896907216493
3912,Willy Wonka & the Chocolate Factory 2016 Re-release,526954,526633,321,2016.csv,2016,99.93908386690299,0.06091613309700657
3913,Only Yesterday 2016 Re-release,525958,453243,72715,2016.csv,2016,86.17475159613505,13.825248403864949
3914,The Audience 2019 Re-release,523432,106529,416903,2019.csv,2019,20.352022803344084,79.64797719665592
3915,Bolshoi Ballet: Carmen Suite/Petrushka,522179,207523,314656,2019.csv,2019,39.741736071347184,60.25826392865282
3916,Sound City,521181,422853,98328,2013.csv,2013,81.13361768752124,18.866382312478773
3917,The Spy Behind Home Plate,519525,519525,0,2019.csv,2019,100.0,0.0
3918,Wild Nights with Emily,519487,519487,0,2019.csv,2019,100.0,0.0
3919,Scatter My Ashes at Bergdorf's,518342,518342,0,2013.csv,2013,100.0,0.0
3920,Trespass Against Us,517197,5711,511486,2017.csv,2017,1.1042214088635471,98.89577859113645
3921,Grave of the Fireflies,516962,516962,0,2018.csv,2018,100.0,0.0
3922,Listen to Me Marlon,516337,425831,90506,2015.csv,2015,82.4715253797423,17.5284746202577
3923,The Sandlot 2018 Re-release,516130,516130,0,2018.csv,2018,100.0,0.0
3924,"Love, Wedding, Marriage",515823,1926,513897,2011.csv,2011,0.3733838933122408,99.62661610668776
3925,The Big Ugly,515399,514107,1292,2020.csv,2020,99.74932042941488,0.25067957058511947
3926,Preacher's Kid,515065,515065,0,2010.csv,2010,100.0,0.0
3927,A Hard Day's Night 2014 Re-release,515005,515005,0,2014.csv,2014,100.0,0.0
3928,Goodbye First Love,514913,95000,419913,2011.csv,2011,18.44971869034186,81.55028130965813
3929,Bullitt 2018 Re-release,511350,511350,0,2018.csv,2018,100.0,0.0
3930,Black Butler: Book of the Atlantic,511132,248286,262846,2017.csv,2017,48.57571038401039,51.42428961598961
3931,Monsters and Men,510967,500101,10866,2018.csv,2018,97.87344388189453,2.1265561181054746
3932,Unsullied,510957,510957,0,2016.csv,2016,100.0,0.0
3933,Bol,509872,188850,321022,2011.csv,2011,37.03870775410299,62.961292245897006
3934,Saving Private Ryan 2019 Re-release,508694,508694,0,2019.csv,2019,100.0,0.0
3935,Una,508169,22815,485354,2017.csv,2017,4.489648128870514,95.51035187112949
3936,The Inevitable Defeat of Mister & Pete,506303,494608,11695,2013.csv,2013,97.69011836785482,2.309881632145178
3937,Our Last Tango,505885,100086,405799,2015.csv,2015,19.784338337764513,80.21566166223549
3938,Gabriel and the Mountain,505769,18415,487354,2017.csv,2017,3.640990254444223,96.35900974555578
3939,Have a Nice Day,504003,79393,424610,2018.csv,2018,15.752485600284125,84.24751439971587
3940,Letters From Baghdad,502941,359735,143206,2017.csv,2017,71.52628240688271,28.473717593117282
3941,Chuck,502518,320725,181793,2017.csv,2017,63.82358442881648,36.17641557118352
3942,Deli Man,502294,502294,0,2015.csv,2015,100.0,0.0
3943,Bride Flight 2011 Re-release,501360,501360,0,2011.csv,2011,100.0,0.0
3944,Synonyms,501223,206003,295220,2019.csv,2019,41.1000692306618,58.89993076933819
3945,Spell,500104,500104,0,2020.csv,2020,100.0,0.0
3946,Smashed,499725,376597,123128,2012.csv,2012,75.36084846665666,24.63915153334334
3947,Hamari Adhuri Kahani,498774,235361,263413,2015.csv,2015,47.18790474242843,52.81209525757157
3948,Whisper of the Heart 2019 Re-release,498156,498156,0,2019.csv,2019,100.0,0.0
3949,Kahlil Gibran's The Prophet 2015 Re-release,496914,370146,126768,2015.csv,2015,74.48894577331289,25.511054226687115
3950,Felix and Meira,496714,447353,49361,2015.csv,2015,90.06249068880685,9.937509311193162
3951,April and the Extraordinary World,495879,295488,200391,2015.csv,2015,59.58873031525837,40.41126968474164
3952,Nausicaä of the Valley of the Wind 2019 Re-release,495770,495770,0,2019.csv,2019,100.0,0.0
3953,Eden,494949,65460,429489,2014.csv,2014,13.225605062339756,86.77439493766025
3954,Steve Jobs: The Man in the Machine,494506,494506,0,2015.csv,2015,100.0,0.0
3955,Monty Python's Life of Brian 2019 Re-release,494444,161507,332937,2019.csv,2019,32.66436643987994,67.33563356012006
3956,The Polar Express 2013 IMAX Release,493776,493776,0,2013.csv,2013,100.0,0.0
3957,Two Night Stand,492332,18612,473720,2014.csv,2014,3.780375843942705,96.2196241560573
3958,Soul on a String,491294,3669,487625,2017.csv,2017,0.7468033397517576,99.25319666024825
3959,Wolves,491154,12139,479015,2014.csv,2014,2.4715262422783892,97.52847375772161
3960,Open Grave,489812,0,489812,2013.csv,2013,0.0,100.0
3961,Zama,489692,200600,289092,2017.csv,2017,40.96452463997778,59.03547536002222
3962,L'amour fou,489126,312494,176632,2010.csv,2010,63.88824147561159,36.1117585243884
3963,What Richard Did,488327,2749,485578,2012.csv,2012,0.562942454543779,99.43705754545621
3964,At Any Price,487455,380594,106861,2013.csv,2013,78.07777128145162,21.92222871854838
3965,London Fields,487420,252676,234744,2018.csv,2018,51.83948135078577,48.16051864921423
3966,Beach Rats,486623,473771,12852,2017.csv,2017,97.3589411104695,2.6410588895304987
3967,Summerland,486218,58498,427720,2020.csv,2020,12.031228790377979,87.96877120962202
3968,Cooties,485544,60058,425486,2015.csv,2015,12.369218855551711,87.63078114444829
3969,The Russian Five,485049,485049,0,2019.csv,2019,100.0,0.0
3970,63 Up,483684,483684,0,2019.csv,2019,100.0,0.0
3971,Our Little Sister 2016 Re-release,483559,467555,16004,2016.csv,2016,96.69037283971552,3.3096271602844745
3972,Lawrence of Arabia 2019 Re-release,482281,482281,0,2019.csv,2019,100.0,0.0
3973,The Journey,482209,155475,326734,2017.csv,2017,32.24224350852016,67.75775649147984
3974,I Origins,481234,336472,144762,2014.csv,2014,69.91858430617953,30.081415693820468
3975,Breathe In,481079,89661,391418,2013.csv,2013,18.63747949920907,81.36252050079094
3976,Father of My Children,480834,144022,336812,2010.csv,2010,29.952540793704273,70.04745920629573
3977,The Third Man 2015 Re-release,478945,449191,29754,2015.csv,2015,93.78759565294553,6.212404347054464
3978,Brotherly Love,478595,478595,0,2015.csv,2015,100.0,0.0
3979,Liam Gallagher: As It Was,477009,0,477009,2019.csv,2019,0.0,100.0
3980,Heart of a Dog,476384,420813,55571,2015.csv,2015,88.33483072479345,11.665169275206557
3981,The Babymakers,475511,7889,467622,2012.csv,2012,1.6590573088740326,98.34094269112596
3982,Gorillaz: Reject False Icons,475465,453687,21778,2019.csv,2019,95.41964182431934,4.58035817568065
3983,The Shawshank Redemption 2019 Re-release,473776,358507,115269,2019.csv,2019,75.67014791800345,24.329852081996556
3984,On the Job,472890,164620,308270,2013.csv,2013,34.81147835648882,65.18852164351118
3985,Pearl Jam Twenty,471334,471334,0,2011.csv,2011,100.0,0.0
3986,Darbareye Elly 2015 Re-release,470760,470760,0,2015.csv,2015,100.0,0.0
3987,White Bird in a Blizzard,469701,33821,435880,2014.csv,2014,7.200538214736609,92.79946178526339
3988,Matangi/Maya/M.I.A,469489,230808,238681,2018.csv,2018,49.16153520103773,50.83846479896228
3989,DCI 2017 Tour Premeire,467817,467817,0,2017.csv,2017,100.0,0.0
3990,Time Freak,467693,10003,457690,2018.csv,2018,2.1387961761240812,97.86120382387593
3991,Hail Satan?,467361,424284,43077,2019.csv,2019,90.78292797216713,9.217072027832875
3992,True History of the Kelly Gang,467198,33817,433381,2020.csv,2020,7.238258725422626,92.76174127457737
3993,Last Days in Vietnam,466114,466114,0,2014.csv,2014,100.0,0.0
3994,Neighboring Sounds,465082,60255,404827,2012.csv,2012,12.95577984097428,87.04422015902573
3995,Ghanchakkar,464803,203044,261759,2013.csv,2013,43.683883279582965,56.31611672041704
3996,Puffs: Filmed Live Off Broadway,464483,464483,0,2018.csv,2018,100.0,0.0
3997,Deepsea Challenge,462959,235659,227300,2014.csv,2014,50.90277972779447,49.097220272205526
3998,Before We Go,462875,37151,425724,2015.csv,2015,8.02614096678369,91.97385903321631
3999,The Bag Man,461780,56574,405206,2014.csv,2014,12.251288492355668,87.74871150764433
4000,MFKZ,461724,229423,232301,2018.csv,2018,49.68834195320148,50.31165804679853
4001,Scotty and the Secret History of Hollywood,461689,461689,0,2018.csv,2018,100.0,0.0
4002,Bully,461405,279202,182203,2012.csv,2012,60.51126450732003,39.488735492679965
4003,Disorder,460997,51879,409118,2015.csv,2015,11.25365240988553,88.74634759011447
4004,The Dark Knight 2018 Re-release,460178,375589,84589,2018.csv,2018,81.61819991394634,18.38180008605366
4005,Inside Out 2020 Re-release,460176,460000,176,2020.csv,2020,99.96175376377734,0.038246236222662634
4006,Manglehorn,459636,143101,316535,2015.csv,2015,31.133549156288893,68.8664508437111
4007,Christmas Jars,459462,459462,0,2019.csv,2019,100.0,0.0
4008,Eric Clapton: A Life in 12 Bars,459088,0,459088,2017.csv,2017,0.0,100.0
4009,South Pacific 2018 Re-release,458000,458000,0,2018.csv,2018,100.0,0.0
4010,We Steal Secrets,457517,166243,291274,2013.csv,2013,36.33591757246179,63.66408242753822
4011,Paradise: Hope,457132,6701,450431,2013.csv,2013,1.4658785646159096,98.5341214353841
4012,Sound of Noise,456366,24565,431801,2010.csv,2010,5.382741045564305,94.61725895443568
4013,Staying Vertical,456271,12158,444113,2016.csv,2016,2.6646444766377875,97.33535552336221
4014,Lola Versus,455754,252603,203151,2012.csv,2012,55.42529522505563,44.57470477494438
4015,The Gospel According to André,454550,400713,53837,2018.csv,2018,88.1559784402156,11.844021559784403
4016,The Most Dangerous Man in America: Daniel Ellsberg and the Pentagon Papers,453993,453993,0,2010.csv,2010,100.0,0.0
4017,Leaning Into The Wind,452372,400530,51842,2018.csv,2018,88.53996268557735,11.460037314422642
4018,Sailor Moon R: The Movie: The Promise of the Rose,452053,452053,0,2017.csv,2017,100.0,0.0
4019,The Perfect Host,450885,48764,402121,2011.csv,2011,10.815174601062354,89.18482539893763
4020,Perfect Blue 2017 Re-release,450594,446062,4532,2017.csv,2017,98.99421652307842,1.0057834769215745
4021,Kill List,450275,29063,421212,2011.csv,2011,6.454500027760812,93.54549997223918
4022,Pearl Jam: Let's Play Two,450273,348833,101440,2017.csv,2017,77.47144510108312,22.52855489891688
4023,Hesher,449702,382946,66756,2011.csv,2011,85.15550297752735,14.84449702247266
4024,17 Girls,449626,15123,434503,2011.csv,2011,3.3634620773709702,96.63653792262903
4025,The Rocket,449064,56823,392241,2013.csv,2013,12.65365293143071,87.34634706856929
4026,Before We Vanish,448829,52087,396742,2017.csv,2017,11.605087906530104,88.39491209346988
4027,The Sleeping Beauty,446131,29066,417065,2011.csv,2011,6.515126722868395,93.48487327713161
4028,Cruel Intentions 2019 Re-release,445218,445218,0,2019.csv,2019,100.0,0.0
4029,Charlie Countryman,443990,11650,432340,2013.csv,2013,2.6239329714633213,97.37606702853668
4030,Porco Rosso 2018 Re-release,443059,443059,0,2018.csv,2018,100.0,0.0
4031,Prince Avalanche,442313,205139,237174,2013.csv,2013,46.378695629565485,53.62130437043451
4032,Elf 2018 Re-release,442073,442073,0,2018.csv,2018,100.0,0.0
4033,Bastards,439935,24525,415410,2013.csv,2013,5.574687169695523,94.42531283030448
4034,Bitch Slap,439587,17365,422222,2010.csv,2010,3.950298803194817,96.04970119680519
4035,Burden,439139,139270,299869,2020.csv,2020,31.714331908575645,68.28566809142436
4036,Desert Dancer,438165,155271,282894,2014.csv,2014,35.43665057683749,64.5633494231625
4037,CatVideoFest 2020,437625,437625,0,2020.csv,2020,100.0,0.0
4038,My Kingdom,435759,36533,399226,2011.csv,2011,8.383762584364293,91.61623741563571
4039,We the Animals,434743,400961,33782,2018.csv,2018,92.22943210126444,7.7705678987355755
4040,What We Left Behind: Star Trek DS9,434437,382457,51980,2019.csv,2019,88.03508909231948,11.964910907680515
4041,DCI 2018 Tour Premeire,434008,434008,0,2018.csv,2018,100.0,0.0
4042,Rosenwald,433924,433924,0,2015.csv,2015,100.0,0.0
4043,Bjork: Biophilia Live,433686,127754,305932,2014.csv,2014,29.457718256987775,70.54228174301223
4044,I Want Your Money,433588,433588,0,2010.csv,2010,100.0,0.0
4045,The Sower,433112,36233,396879,2018.csv,2018,8.365734498236021,91.63426550176398
4046,Harmony,430568,23248,407320,2015.csv,2015,5.3993794243882505,94.60062057561174
4047,Ghostbusters 2019 Re-release,430435,369612,60823,2019.csv,2019,85.86941117706506,14.13058882293494
4048,Andy Irons: Kissed by God,430393,285933,144460,2018.csv,2018,66.43532771211427,33.56467228788572
4049,Iron Man 2020 Re-release,430000,430000,0,2020.csv,2020,100.0,0.0
4050,Go Goa Gone,429350,298457,130893,2013.csv,2013,69.51368347502039,30.486316524979625
4051,On the Beach at Night Alone,429159,37489,391670,2017.csv,2017,8.735457021756506,91.2645429782435
4052,Infamous,429148,429148,0,2020.csv,2020,100.0,0.0
4053,Guardians of the Galaxy 2020 Re-release,428424,406000,22424,2020.csv,2020,94.76593281422142,5.234067185778574
4054,Blackway,426491,27079,399412,2016.csv,2016,6.349254732221782,93.6507452677782
4055,Happy Bhaag Jayegi,426345,351840,74505,2016.csv,2016,82.5247158990958,17.475284100904197
4056,Killing Sarai,425332,425332,0,2019.csv,2019,100.0,0.0
4057,Vertigo 2018 Re-release,425152,394212,30940,2018.csv,2018,92.72260273972603,7.277397260273973
4058,Sound of My Voice,424088,408015,16073,2012.csv,2012,96.20998472015242,3.7900152798475784
4059,Viva,423976,178008,245968,2016.csv,2016,41.98539539973961,58.01460460026039
4060,God Help the Girl,423306,102757,320549,2014.csv,2014,24.27487444071192,75.72512555928807
4061,Cirque du Soleil in Cinema: KURIOS - Cabinet of Curiosities,422760,413039,9721,2018.csv,2018,97.70058662125084,2.299413378749172
4062,Mississippi Grind,422746,130541,292205,2015.csv,2015,30.87929868053157,69.12070131946842
4063,Behaving Badly,422697,0,422697,2014.csv,2014,0.0,100.0
4064,Ben-Hur 2019 Re-release,422622,422622,0,2019.csv,2019,100.0,0.0
4065,Super,422618,327716,94902,2011.csv,2011,77.54425982802437,22.455740171975638
4066,Settai,422247,87838,334409,2013.csv,2013,20.802516062873153,79.19748393712685
4067,Mad Max: Fury Road 2016 Re-release,421986,421986,0,2016.csv,2016,100.0,0.0
4068,She's Beautiful When She's Angry,421573,421573,0,2014.csv,2014,100.0,0.0
4069,The Bounce Back,421404,321910,99494,2016.csv,2016,76.38987764710349,23.610122352896507
4070,The Cold Blue,420177,420177,0,2019.csv,2019,100.0,0.0
4071,Voiceless,419952,419952,0,2016.csv,2016,100.0,0.0
4072,Frankenstein 2018 Re-release,417783,417783,0,2018.csv,2018,100.0,0.0
4073,Happy Phirr Bhag Jayegi,417669,103385,314284,2018.csv,2018,24.75285453313509,75.24714546686491
4074,Bolshoi Ballet: Le Corsaire,417152,190192,226960,2019.csv,2019,45.59297330469469,54.407026695305305
4075,Dirty Wars,416853,384473,32380,2013.csv,2013,92.2322737271892,7.7677262728107985
4076,Tales of Halloween,416792,0,416792,2015.csv,2015,0.0,100.0
4077,Manifesto,416389,161101,255288,2017.csv,2017,38.69002303134809,61.30997696865192
4078,Status Update,416178,4764,411414,2018.csv,2018,1.1447025071003272,98.85529749289968
4079,Sand Storm,414698,86800,327898,2016.csv,2016,20.930894289338266,79.06910571066173
4080,The Ottoman Lieutenant,413844,240978,172866,2017.csv,2017,58.229187809899386,41.77081219010062
4081,The Mafia Kills Only in Summer 2015 Re-release,413236,37134,376102,2015.csv,2015,8.986148351063315,91.01385164893668
4082,The Moth Diaries,413035,3838,409197,2012.csv,2012,0.9292190734441392,99.07078092655586
4083,Unbranded,412792,410185,2607,2015.csv,2015,99.36844706292757,0.6315529370724239
4084,Tulsa,412269,412269,0,2020.csv,2020,100.0,0.0
4085,Rage,411967,5594,406373,2010.csv,2010,1.3578757521840341,98.64212424781597
4086,R... Rajkumar,410495,166503,243992,2013.csv,2013,40.56151719265764,59.43848280734235
4087,Badlapur,409166,409166,0,2015.csv,2015,100.0,0.0
4088,Song One,408918,32251,376667,2015.csv,2015,7.8869113122924395,92.11308868770756
4089,The Reliant,408747,408747,0,2019.csv,2019,100.0,0.0
4090,Sleeping Beauty,408680,36578,372102,2011.csv,2011,8.950278946853283,91.04972105314671
4091,The 5th Quarter,408159,408159,0,2011.csv,2011,100.0,0.0
4092,Back to the Future 2020 Re-release,407977,247000,160977,2020.csv,2020,60.54262862857465,39.457371371425346
4093,"Love, Kennedy",407871,407871,0,2017.csv,2017,100.0,0.0
4094,Please Stand By,406732,9868,396864,2018.csv,2018,2.426167599303718,97.57383240069628
4095,Chasing Trane: The John Coltrane Documentary,406284,406284,0,2017.csv,2017,100.0,0.0
4096,Gabrielle,406256,5534,400722,2013.csv,2013,1.3621952660391476,98.63780473396085
4097,The Square 2010 Re-release,406116,406116,0,2010.csv,2010,100.0,0.0
4098,The Hunting Ground,405917,405917,0,2015.csv,2015,100.0,0.0
4099,The Tempest,405861,277943,127918,2010.csv,2010,68.48231291008497,31.517687089915018
4100,Stake Land,405380,33245,372135,2011.csv,2011,8.200947259361586,91.79905274063842
4101,Happy Magic,405268,10697,394571,2011.csv,2011,2.639487943780412,97.36051205621959
4102,The Philadelphia Story 2018 Re-release,404524,404524,0,2018.csv,2018,100.0,0.0
4103,God's Pocket,403713,169976,233737,2014.csv,2014,42.10317725711087,57.89682274288913
4104,Meet Me in St. Louis 75th Anniversary,403521,403521,0,2019.csv,2019,100.0,0.0
4105,The Apu Trilogy,402723,402723,0,2015.csv,2015,100.0,0.0
4106,Drinking Buddies,401914,343341,58573,2013.csv,2013,85.42648427275486,14.573515727245132
4107,The Oath,401463,401463,0,2018.csv,2018,100.0,0.0
4108,Freetown,401328,401328,0,2015.csv,2015,100.0,0.0
4109,"Hello, Dolly!",400881,400881,0,2019.csv,2019,100.0,0.0
4110,Racer and the Jailbird,400026,46337,353689,2017.csv,2017,11.583497072690276,88.41650292730972
4111,West Side Story 2018 Re-release,398670,398670,0,2018.csv,2018,100.0,0.0
4112,She Dies Tomorrow,398663,398663,0,2020.csv,2020,100.0,0.0
4113,Space Mutiny,397887,397887,0,2018.csv,2018,100.0,0.0
4114,Berlin Syndrome,397783,28660,369123,2017.csv,2017,7.2049333430538764,92.79506665694612
4115,Krull 2018 Re-release,397157,397157,0,2018.csv,2018,100.0,0.0
4116,God Bless America,393880,122550,271330,2012.csv,2012,31.113537117903928,68.88646288209607
4117,Into the Abyss,393714,223880,169834,2011.csv,2011,56.86361165719278,43.136388342807216
4118,Three,391957,331507,60450,2016.csv,2016,84.57738986674559,15.422610133254414
4119,Tiny Furniture,391674,391674,0,2010.csv,2010,100.0,0.0
4120,The Escape,390881,14018,376863,2018.csv,2018,3.5862577101470783,96.41374228985292
4121,Detropia,390024,390024,0,2012.csv,2012,100.0,0.0
4122,Once Upon a Time in Mumbaai Dobara,389237,0,389237,2013.csv,2013,0.0,100.0
4123,Singh Saab the Great,388622,225668,162954,2013.csv,2013,58.0687660503008,41.93123394969919
4124,Keep the Lights On,388331,246112,142219,2012.csv,2012,63.37686149187163,36.62313850812838
4125,"Westwood: Punk, Icon, Activist",386856,58979,327877,2018.csv,2018,15.245724507310213,84.75427549268979
4126,Hitchcock/Truffaut,386471,260430,126041,2015.csv,2015,67.38668619378944,32.613313806210556
4127,The Wedding Guest,386166,386166,0,2019.csv,2019,100.0,0.0
4128,How to Talk to Girls at Parties,385733,84809,300924,2018.csv,2018,21.986451768451236,78.01354823154877
4129,Samurai Cop,384756,384756,0,2017.csv,2017,100.0,0.0
4130,Bethlehem,384670,201700,182970,2014.csv,2014,52.43455429329035,47.565445706709646
4131,The Secret World of Arrietty 2019 Re-release,384289,384289,0,2019.csv,2019,100.0,0.0
4132,Digimon Adventure tri. Part 5: Coexistence,382119,52339,329780,2017.csv,2017,13.697042020941119,86.30295797905887
4133,Z for Zachariah,381839,121461,260378,2015.csv,2015,31.80947991169053,68.19052008830947
4134,Flower,380553,328188,52365,2018.csv,2018,86.23976161007796,13.760238389922034
4135,Jane and Emma,380030,380030,0,2018.csv,2018,100.0,0.0
4136,Daughter of Mine,379010,10628,368382,2018.csv,2018,2.804147647819319,97.19585235218068
4137,I'll Push You: A Real-Life Inspiration,378899,378899,0,2017.csv,2017,100.0,0.0
4138,Shahid,377803,12153,365650,2013.csv,2013,3.216755822478911,96.78324417752108
4139,Miss Hokusai,377702,222670,155032,2015.csv,2015,58.9538842791407,41.0461157208593
4140,Attack on Titan: Smoke Signal,377334,377334,0,2018.csv,2018,100.0,0.0
4141,Le talent de mes amis,376522,889,375633,2015.csv,2015,0.23610838144915836,99.76389161855084
4142,Great Performances at the Met: Puccini: Turandot,375295,0,375295,2019.csv,2019,0.0,100.0
4143,Chronic,374704,9033,365671,2016.csv,2016,2.4107028481147785,97.58929715188522
4144,Jurassic Park 2018 Re-release,374238,374238,0,2018.csv,2018,100.0,0.0
4145,Pom Poko 2018 Re-release,372405,372405,0,2018.csv,2018,100.0,0.0
4146,Eloise,372137,0,372137,2017.csv,2017,0.0,100.0
4147,Fanny,371657,8735,362922,2013.csv,2013,2.3502853437443667,97.64971465625564
4148,7 Boxes,370892,38106,332786,2013.csv,2013,10.274149887298728,89.72585011270127
4149,Hava Nagila,370218,370218,0,2013.csv,2013,100.0,0.0
4150,"Ruben Brandt, Collector 2018 Re-release",369809,117963,251846,2018.csv,2018,31.898358341738575,68.10164165826143
4151,Mooz-Lum,369129,369129,0,2011.csv,2011,100.0,0.0
4152,When Comedy Went to School,369065,369065,0,2013.csv,2013,100.0,0.0
4153,Fatima,368600,0,368600,2020.csv,2020,0.0,100.0
4154,The Void,368372,151042,217330,2017.csv,2017,41.00257348549835,58.99742651450165
4155,Dark Awakening,367925,0,367925,2015.csv,2015,0.0,100.0
4156,Yellow Rose,367849,367849,0,2020.csv,2020,100.0,0.0
4157,Cunningham,367560,265102,102458,2019.csv,2019,72.12482315812385,27.875176841876154
4158,Room 237,367406,296359,71047,2012.csv,2012,80.66253681213699,19.33746318786302
4159,INXS: Baby Live at Wembly Stadium,366425,161750,204675,2019.csv,2019,44.14273043596916,55.857269564030844
4160,Grease 2010 Sing-a-long,365802,365802,0,2010.csv,2010,100.0,0.0
4161,Eat That Question,365540,355074,10466,2016.csv,2016,97.13683864966899,2.8631613503310174
4162,Glen Campbell: I'll Be Me,365422,365422,0,2014.csv,2014,100.0,0.0
4163,Lords of Chaos,365353,253184,112169,2019.csv,2019,69.2984592982677,30.7015407017323
4164,Clemency,364952,364716,236,2019.csv,2019,99.93533396172647,0.06466603827352638
4165,BOSTON: An American Running Story,364369,364369,0,2017.csv,2017,100.0,0.0
4166,The Kid Detective,364138,364138,0,2020.csv,2020,100.0,0.0
4167,Jig,363320,183790,179530,2011.csv,2011,50.58626004624023,49.41373995375977
4168,The Breadwinner,363307,312381,50926,2017.csv,2017,85.98265378866908,14.017346211330914
4169,Breathless 2010 Re-release,363031,363031,0,2010.csv,2010,100.0,0.0
4170,The Tobacconist,360996,0,360996,2019.csv,2019,0.0,100.0
4171,These Final Hours,360234,0,360234,2014.csv,2014,0.0,100.0
4172,Souvenir,359798,11411,348387,2016.csv,2016,3.1715017871138804,96.82849821288612
4173,Disney Junior HalloVeen Party!,359745,359745,0,2017.csv,2017,100.0,0.0
4174,Happy Ending,359542,313770,45772,2014.csv,2014,87.26935935161956,12.73064064838044
4175,K-12,359377,303230,56147,2019.csv,2019,84.37657390428436,15.623426095715642
4176,Government 3,358928,249588,109340,2017.csv,2017,69.5370659296572,30.4629340703428
4177,Love in Space,358486,34787,323699,2011.csv,2011,9.703865701868414,90.29613429813159
4178,Everly,358156,0,358156,2015.csv,2015,0.0,100.0
4179,Welcome to the Rileys,358014,158898,199116,2010.csv,2010,44.38318054601217,55.61681945398783
4180,Bel Canto,357462,125569,231893,2018.csv,2018,35.12792968203613,64.87207031796387
4181,National Gallery,354971,253941,101030,2014.csv,2014,71.53852004811661,28.461479951883394
4182,Hello I Must Be Going,354939,106709,248230,2012.csv,2012,30.064039172928307,69.9359608270717
4183,The Invitation,354835,231737,123098,2016.csv,2016,65.30838276945623,34.69161723054378
4184,Kaashmora,354631,327959,26672,2016.csv,2016,92.47894290121282,7.52105709878719
4185,Las Acacias,354391,6000,348391,2011.csv,2011,1.6930452522778514,98.30695474772216
4186,The Tomorrow Man,354103,354103,0,2019.csv,2019,100.0,0.0
4187,Like Dandelion Dust,352810,352810,0,2010.csv,2010,100.0,0.0
4188,Long Strange Trip - The Untold Story of The Grateful Dead,351957,351957,0,2017.csv,2017,100.0,0.0
4189,The Wizard of Oz 2018 Re-release,351839,351839,0,2018.csv,2018,100.0,0.0
4190,Aferim!,350110,108110,242000,2015.csv,2015,30.878866641912538,69.12113335808746
4191,Howards End 2016 Re-release,349993,160282,189711,2016.csv,2016,45.795773058318304,54.20422694168169
4192,Tehran Taboo,349886,74758,275128,2017.csv,2017,21.36638790920471,78.6336120907953
4193,Satanic,349183,252,348931,2016.csv,2016,0.07216846180942371,99.92783153819059
4194,Suicide the Ripple Effect,347468,347468,0,2018.csv,2018,100.0,0.0
4195,The Good Heart,346851,20930,325921,2010.csv,2010,6.034291381601898,93.9657086183981
4196,The Vault,346729,5728,341001,2017.csv,2017,1.6520106480853922,98.3479893519146
4197,Star Trek: The Motion Picture 2019 Re-release,346243,346243,0,2019.csv,2019,100.0,0.0
4198,Triple Threat,345900,76289,269611,2019.csv,2019,22.055218271176642,77.94478172882336
4199,Tesla,345229,93147,252082,2020.csv,2020,26.98122116044712,73.01877883955288
4200,Countdown to Canelo vs. Chavez Jr.,343387,343387,0,2017.csv,2017,100.0,0.0
4201,El Bulli: Cooking in Progress,343116,237181,105935,2011.csv,2011,69.12560183727952,30.874398162720478
4202,The Idol,343059,0,343059,2016.csv,2016,0.0,100.0
4203,Koch,342941,342941,0,2013.csv,2013,100.0,0.0
4204,"Life, Animated",342664,255388,87276,2016.csv,2016,74.53015198561856,25.469848014381434
4205,Bolshoi Ballet: Swan Lake,342391,88905,253486,2018.csv,2018,25.965927842729513,74.03407215727049
4206,Nureyev: Lifting the Curtain,342255,165203,177052,2018.csv,2018,48.2689807307417,51.731019269258304
4207,Knife + Heart,341847,32516,309331,2018.csv,2018,9.511857643916724,90.48814235608327
4208,First Love,340032,218329,121703,2018.csv,2018,64.20836862412949,35.79163137587051
4209,The Lady in the Car with Glasses and a Gun,339461,2167,337294,2015.csv,2015,0.6383649373565741,99.36163506264343
4210,The Green Prince,339208,258237,80971,2014.csv,2014,76.12939553312422,23.87060446687578
4211,Happy People: A Year in the Taiga,338987,338987,0,2013.csv,2013,100.0,0.0
4212,Red Hook Summer,338803,338803,0,2012.csv,2012,100.0,0.0
4213,Is It Wrong to Try to Pick Up Girls in a Dungeon - Arrow of the Orion,338632,271489,67143,2019.csv,2019,80.17228141463299,19.82771858536701
4214,Silencio,338596,158723,179873,2018.csv,2018,46.87680894044821,53.1231910595518
4215,Dark Horse,337150,166228,170922,2012.csv,2012,49.30387068070592,50.69612931929408
4216,Voyage of Time: The IMAX Experience,337038,55409,281629,2016.csv,2016,16.439985995644406,83.5600140043556
4217,Kings of Pastry,336386,336386,0,2010.csv,2010,100.0,0.0
4218,Diane,336166,336166,0,2019.csv,2019,100.0,0.0
4219,Sailor Moon R: The Movie: The Promise of the Rose/Sailor Moon S: The Movie - Hearts in Ice,335697,335697,0,2018.csv,2018,100.0,0.0
4220,Freaks,335050,276591,58459,2019.csv,2019,82.55215639456797,17.447843605432027
4221,Russ Taff: I Still Believe,334983,334983,0,2018.csv,2018,100.0,0.0
4222,Bhavesh Joshi Superhero,334723,57376,277347,2018.csv,2018,17.14133776286661,82.8586622371334
4223,Anthropocene: The Human Epoch,334162,104806,229356,2019.csv,2019,31.36382951981374,68.63617048018625
4224,A Silent Voice: The Movie 2019 Re-release,333984,333984,0,2019.csv,2019,100.0,0.0
4225,Ballet 422,333554,333554,0,2015.csv,2015,100.0,0.0
4226,Shine,333388,333388,0,2018.csv,2018,100.0,0.0
4227,Something from Nothing: The Art of Rap,333388,288000,45388,2012.csv,2012,86.38583272343335,13.614167276566643
4228,Linsanity,332990,302645,30345,2013.csv,2013,90.88711372713895,9.112886272861047
4229,Don't Hang Up,332571,0,332571,2017.csv,2017,0.0,100.0
4230,Shamitabh,331821,324597,7224,2015.csv,2015,97.82292259983545,2.1770774001645465
4231,The Big Fight Live: IBF Welterweight Title: Errol Spence Jr. vs. Mikey Garcia,328979,328979,0,2019.csv,2019,100.0,0.0
4232,Ladies vs. Ricky Bahl,328870,0,328870,2011.csv,2011,0.0,100.0
4233,The Last Sentence,328005,62506,265499,2012.csv,2012,19.056416822914287,80.94358317708571
4234,Elaine Stritch: Shoot Me,327452,327452,0,2014.csv,2014,100.0,0.0
4235,You Will Be My Son 2012 Re-release,326061,285151,40910,2012.csv,2012,87.45326794679524,12.546732053204767
4236,Formosa Betrayed,326034,225341,100693,2010.csv,2010,69.11579773888613,30.88420226111387
4237,Lucy in the Sky,325950,319976,5974,2019.csv,2019,98.16720355882805,1.8327964411719588
4238,The Central Park Five,325653,325653,0,2012.csv,2012,100.0,0.0
4239,The Opera House,325235,320079,5156,2018.csv,2018,98.41468476639969,1.5853152336003196
4240,Irresistible,325059,0,325059,2020.csv,2020,0.0,100.0
4241,Camp,324977,324977,0,2013.csv,2013,100.0,0.0
4242,Juan of the Dead,324834,18000,306834,2012.csv,2012,5.541291859842258,94.45870814015774
4243,Teefa In Trouble,324633,0,324633,2018.csv,2018,0.0,100.0
4244,Red Hill,324424,21087,303337,2010.csv,2010,6.499827386383251,93.50017261361675
4245,The Bolshoi Ballet: Live From Moscow - The Nutcracker,323928,323928,0,2018.csv,2018,100.0,0.0
4246,The Cured,323776,26630,297146,2018.csv,2018,8.224822099229097,91.7751779007709
4247,Three Worlds,323748,3952,319796,2012.csv,2012,1.2207025217144198,98.77929747828557
4248,Sword of Trust,323369,322421,948,2019.csv,2019,99.70683646236962,0.2931635376303851
4249,Damsel,323235,305136,18099,2018.csv,2018,94.4006682444661,5.5993317555339
4250,Citizen Jane: Battle for the City,323124,313411,9713,2017.csv,2017,96.99403325039304,3.005966749606962
4251,The Day He Arrives,322348,13746,308602,2011.csv,2011,4.264335438718404,95.7356645612816
4252,Nocturama,321768,30157,291611,2016.csv,2016,9.372280649411998,90.627719350588
4253,Double Trouble,321081,44788,276293,2012.csv,2012,13.949128101631675,86.05087189836831
4254,Woodstock,320610,126562,194048,2019.csv,2019,39.4753750662799,60.5246249337201
4255,Bohemian Rhapsody 2020 Re-release,320550,240000,80550,2020.csv,2020,74.87131492746842,25.12868507253159
4256,A Film Unfinished,320486,320486,0,2010.csv,2010,100.0,0.0
4257,The English Teacher,320013,104810,215203,2013.csv,2013,32.75179445835013,67.24820554164988
4258,Beats,319595,0,319595,2019.csv,2019,0.0,100.0
4259,Meeting Gorbachev,319230,251837,67393,2019.csv,2019,78.88888888888889,21.11111111111111
4260,You Are Here: A Come From Away Story,318885,318885,0,2019.csv,2019,100.0,0.0
4261,The Yellow Handkerchief,318623,318623,0,2010.csv,2010,100.0,0.0
4262,West of Memphis,318317,310154,8163,2012.csv,2012,97.43557522846721,2.56442477153278
4263,Ask Dr. Ruth,318230,297195,21035,2019.csv,2019,93.3900009427144,6.609999057285611
4264,The Student,318123,1126,316997,2016.csv,2016,0.3539511446830314,99.64604885531698
4265,Not Today,318121,318121,0,2013.csv,2013,100.0,0.0
4266,Today's Special,317831,317831,0,2010.csv,2010,100.0,0.0
4267,Inch'Allah,317656,9840,307816,2013.csv,2013,3.0976905835243156,96.90230941647569
4268,Okko's Inn,317547,134787,182760,2018.csv,2018,42.44631503368005,57.55368496631995
4269,Sauvage / Wild,317536,61604,255932,2018.csv,2018,19.40063488864255,80.59936511135746
4270,6 Days,316946,0,316946,2017.csv,2017,0.0,100.0
4271,5 Days of War,316944,17479,299465,2011.csv,2011,5.514854359129688,94.48514564087031
4272,AmeriGeddon,316554,316554,0,2016.csv,2016,100.0,0.0
4273,Corpo Celeste 2011 Re-release,316504,8919,307585,2011.csv,2011,2.8179738644693275,97.18202613553068
4274,The Riot and the Dance,316103,316103,0,2018.csv,2018,100.0,0.0
4275,David and Goliath,316100,316100,0,2015.csv,2015,100.0,0.0
4276,Josh Groban Bridges Live from Madison Square Garden,315173,315173,0,2019.csv,2019,100.0,0.0
4277,Obit.,315049,315049,0,2017.csv,2017,100.0,0.0
4278,Time Out of Mind,314082,166775,147307,2015.csv,2015,53.09919065721691,46.9008093427831
4279,Christine,313465,298525,14940,2016.csv,2016,95.23391766225895,4.7660823377410555
4280,War Witch,313387,70544,242843,2012.csv,2012,22.510187084977996,77.489812915022
4281,The Bolshoi Ballet: Live From Moscow - Romeo and Juliet,313088,313088,0,2018.csv,2018,100.0,0.0
4282,Berberian Sound Studio,312757,38493,274264,2012.csv,2012,12.30763819834568,87.69236180165431
4283,The Hornet's Nest,312706,312706,0,2014.csv,2014,100.0,0.0
4284,David Lynch: The Art Life,311470,171419,140051,2017.csv,2017,55.035476931967764,44.964523068032236
4285,Plácido Domingo Gala,311246,52502,258744,2019.csv,2019,16.868329231540326,83.13167076845967
4286,Dancing in Jaffa,311001,151098,159903,2014.csv,2014,48.58440969643185,51.41559030356816
4287,Being Elmo: A Puppeteer's Journey,310812,304052,6760,2011.csv,2011,97.82505179980181,2.1749482001981906
4288,I Am Eleven 2014 Re-release,310116,310116,0,2014.csv,2014,100.0,0.0
4289,The Amazing Catfish,308349,11342,297007,2014.csv,2014,3.678299589101959,96.32170041089803
4290,Merchants of Doubt,308156,308156,0,2015.csv,2015,100.0,0.0
4291,Great Performances at the Met: MET Opera: Magic Flute,307686,307686,0,2018.csv,2018,100.0,0.0
4292,Sputnik,307062,18853,288209,2020.csv,2020,6.139802385186053,93.86019761481394
4293,Half of a Yellow Sun,306393,54529,251864,2014.csv,2014,17.797077609475412,82.20292239052459
4294,The Mercy 2018 Re-release,306205,29538,276667,2018.csv,2018,9.646478666253,90.353521333747
4295,Monsters: Dark Continent,306004,0,306004,2015.csv,2015,0.0,100.0
4296,Under the Sun,305993,105036,200957,2016.csv,2016,34.32627543767341,65.67372456232658
4297,The Third Wife,305755,84933,220822,2019.csv,2019,27.778123006982714,72.22187699301729
4298,The Kingmaker,304840,122587,182253,2019.csv,2019,40.21355465162052,59.78644534837948
4299,Showtime Championship Boxing: Deontay Wilder vs. Tyson Fury,304482,304482,0,2018.csv,2018,100.0,0.0
4300,Microbe & Gasoline,303787,63802,239985,2015.csv,2015,21.002215368004556,78.99778463199544
4301,N.H 10,303587,303587,0,2015.csv,2015,100.0,0.0
4302,Alamar,303574,61613,241961,2010.csv,2010,20.295875140822336,79.70412485917765
4303,The Bolshoi Ballet: Live From Moscow - Giselle,302681,302681,0,2018.csv,2018,100.0,0.0
4304,The Unknown Known,301604,276497,25107,2014.csv,2014,91.67550828238352,8.324491717616478
4305,Save Yourselves!,301162,301162,0,2020.csv,2020,100.0,0.0
4306,Cliffs of Freedom,300842,72476,228366,2019.csv,2019,24.09105111653293,75.90894888346706
4307,Sunset Blvd. 2018 Re-release,299645,299645,0,2018.csv,2018,100.0,0.0
4308,Jinn,297381,202348,95033,2014.csv,2014,68.0433517944993,31.956648205500688
4309,Kaptaan,296715,203790,92925,2016.csv,2016,68.68206865173651,31.317931348263485
4310,The We and the I,295930,42172,253758,2012.csv,2012,14.250667387557868,85.74933261244213
4311,Harry Potter and the Sorcerer's Stone 2018 Re-release,295917,295917,0,2018.csv,2018,100.0,0.0
4312,Chic!,295295,5587,289708,2015.csv,2015,1.8920062987859598,98.10799370121404
4313,Gremlins 2020 Re-release,295238,295000,238,2020.csv,2020,99.91938707077003,0.08061292922997716
4314,The Tenth Man,295129,63564,231565,2016.csv,2016,21.537700463187285,78.46229953681272
4315,Aftershock,294696,58510,236186,2013.csv,2013,19.85435838966257,80.14564161033744
4316,Shakira in Concert: El Dorado World Tour,294677,271586,23091,2019.csv,2019,92.16396257597302,7.836037424026985
4317,Khodorkovsky,294599,39522,255077,2011.csv,2011,13.41552415317092,86.58447584682908
4318,Special Treatment,294483,8856,285627,2010.csv,2010,3.00730432656554,96.99269567343445
4319,44 Inch Chest 2010 Re-release,294245,39033,255212,2010.csv,2010,13.26547604887084,86.73452395112916
4320,Innocence,294039,294039,0,2014.csv,2014,100.0,0.0
4321,The Giant Spider Invasion,293053,293053,0,2019.csv,2019,100.0,0.0
4322,Pianomania,292870,49852,243018,2010.csv,2010,17.021886843992213,82.97811315600778
4323,Stonewall,292669,187674,104995,2015.csv,2015,64.12500128131097,35.874998718689035
4324,Mesrine: Public Enemy No. 1 2010 Re-release,292150,275387,16763,2010.csv,2010,94.26219407838438,5.7378059216156085
4325,The Last Five Years,292092,145427,146665,2015.csv,2015,49.78808046779782,50.21191953220219
4326,Dreams of a Life,291898,8405,283493,2011.csv,2011,2.879430485991682,97.12056951400831
4327,The Godfather: Part II 45th Anniversary,291754,291754,0,2019.csv,2019,100.0,0.0
4328,The Man in 3B,291513,291513,0,2015.csv,2015,100.0,0.0
4329,Waste Land,291307,187716,103591,2010.csv,2010,64.43923420995719,35.56076579004281
4330,Big Bad Wolves,291239,33232,258007,2014.csv,2014,11.410559712126467,88.58944028787353
4331,Come Away,290569,126081,164488,2020.csv,2020,43.39107062350079,56.60892937649922
4332,More Than Funny,290498,290498,0,2018.csv,2018,100.0,0.0
4333,Illégal,290108,651,289457,2010.csv,2010,0.22439918926744523,99.77560081073256
4334,Jimmy Vestvood: Amerikan Hero,290080,230069,60011,2016.csv,2016,79.31225868725869,20.687741312741313
4335,Best F(r)iends: Volume 1,290064,252410,37654,2018.csv,2018,87.01872690164929,12.981273098350709
4336,The Zoya Factor,289631,128831,160800,2019.csv,2019,44.48108109974416,55.51891890025584
4337,Best Night Ever,289511,0,289511,2014.csv,2014,0.0,100.0
4338,The Silence of Others,289455,67986,221469,2018.csv,2018,23.48758874436441,76.5124112556356
4339,Welcome to New York,288837,0,288837,2014.csv,2014,0.0,100.0
4340,Antarctica: A Year on Ice,288757,288757,0,2014.csv,2014,100.0,0.0
4341,Above and Beyond,288751,288751,0,2015.csv,2015,100.0,0.0
4342,The Last of Robin Hood,288545,288545,0,2014.csv,2014,100.0,0.0
4343,Saga of Tanya the Evil - The Movie,288460,288460,0,2019.csv,2019,100.0,0.0
4344,Last Train Home,288328,288328,0,2010.csv,2010,100.0,0.0
4345,Resistance,288064,7464,280600,2020.csv,2020,2.5910908686958454,97.40890913130416
4346,Countdown to Zero,287711,272040,15671,2010.csv,2010,94.5532148579651,5.446785142034889
4347,Generation Wealth,287709,237709,50000,2018.csv,2018,82.62132919025821,17.378670809741788
4348,Skate Kitchen,287307,236799,50508,2018.csv,2018,82.42019860288819,17.5798013971118
4349,Post Mortem,286702,9750,276952,2010.csv,2010,3.400743629273601,96.5992563707264
4350,The Interrupters,286457,282448,4009,2011.csv,2011,98.60048803136247,1.3995119686375268
4351,The Dark and the Wicked,285289,110618,174671,2020.csv,2020,38.77401512150836,61.22598487849164
4352,But Deliver Us from Evil,285169,285169,0,2018.csv,2018,100.0,0.0
4353,The Silence 2012 Re-release,284471,100214,184257,2012.csv,2012,35.228195492686424,64.77180450731358
4354,Khalid: Free Spirit,284229,284229,0,2019.csv,2019,100.0,0.0
4355,South of the Border,284214,198600,85614,2010.csv,2010,69.87692372648779,30.12307627351221
4356,The Anonymous People,284147,284147,0,2013.csv,2013,100.0,0.0
4357,The Kindergarten Teacher,284065,36190,247875,2014.csv,2014,12.740041891820534,87.25995810817948
4358,Disney's Newsies: The Broadway Musical! 2018 Re-release,282429,282429,0,2018.csv,2018,100.0,0.0
4359,Created Equal: Clarence Thomas in His Own Words,282149,282149,0,2020.csv,2020,100.0,0.0
4360,Tumbledown,282083,135026,147057,2016.csv,2016,47.867471630690254,52.13252836930974
4361,Ho Mann Jahaan,281926,208611,73315,2016.csv,2016,73.99494902917787,26.00505097082213
4362,Mike Wallace Is Here,281245,281245,0,2019.csv,2019,100.0,0.0
4363,"If I Want to Whistle, I Whistle",280892,12135,268757,2010.csv,2010,4.3201657576577475,95.67983424234225
4364,Octaman,280710,280710,0,2019.csv,2019,100.0,0.0
4365,I Do... Until I Don't,280668,280668,0,2017.csv,2017,100.0,0.0
4366,The Black Power Mixtape 1967-1975,280025,273749,6276,2011.csv,2011,97.75877153825552,2.241228461744487
4367,Wonders of the Sea,279415,100780,178635,2018.csv,2018,36.0682139469964,63.93178605300359
4368,Havenhurst,279372,0,279372,2016.csv,2016,0.0,100.0
4369,"Lovely, Still",279170,127564,151606,2010.csv,2010,45.69402156392163,54.30597843607837
4370,"Lou Andreas-Salomé, The Audacity to be Free",278982,12875,266107,2017.csv,2017,4.614993081990953,95.38500691800905
4371,The Secrets We Keep,278618,207928,70690,2020.csv,2020,74.62834418451068,25.37165581548931
4372,10 Years,278336,203373,74963,2012.csv,2012,73.06744366521039,26.93255633478961
4373,Bolshoi Ballet: The Golden Age,277666,171916,105750,2019.csv,2019,61.914674465004715,38.085325534995285
4374,The Summit,277651,243550,34101,2013.csv,2013,87.71803451095079,12.2819654890492
4375,Science Fair,277338,276195,1143,2018.csv,2018,99.58786751184475,0.41213248815524745
4376,See You Soon,277126,0,277126,2019.csv,2019,0.0,100.0
4377,True Grit 2019 Re-release,276418,276418,0,2019.csv,2019,100.0,0.0
4378,Life After Beth,274717,88273,186444,2014.csv,2014,32.132339826075565,67.86766017392443
4379,Lovely Molly,274480,18464,256016,2012.csv,2012,6.726901777907315,93.27309822209268
4380,Swallow,274259,33419,240840,2020.csv,2020,12.18519720410269,87.81480279589731
4381,The King,273601,259291,14310,2018.csv,2018,94.7697559584943,5.230244041505696
4382,Slayer: The Repentless Killogy,272874,268727,4147,2019.csv,2019,98.48025095831775,1.5197490416822417
4383,Chavela,272842,148666,124176,2017.csv,2017,54.48794540429992,45.51205459570007
4384,Black Death,272445,22554,249891,2010.csv,2010,8.27836811099488,91.72163188900512
4385,One Child Nation,271841,270128,1713,2019.csv,2019,99.3698522297961,0.630147770203906
4386,Come Out and Play,271735,2638,269097,2013.csv,2013,0.9707987561410933,99.0292012438589
4387,The Tale of The Princess Kaguya 2019 Re-release,271681,271681,0,2019.csv,2019,100.0,0.0
4388,Aloft,270971,53086,217885,2015.csv,2015,19.591026345992745,80.40897365400726
4389,The Canyons,270185,56825,213360,2013.csv,2013,21.03188555989415,78.96811444010585
4390,Exposed,269915,0,269915,2016.csv,2016,0.0,100.0
4391,Stalker,269881,269881,0,2017.csv,2017,100.0,0.0
4392,Shirin Farhad Ki Toh Nikal Padi,269845,155758,114087,2012.csv,2012,57.72128444106802,42.27871555893198
4393,The Loneliest Planet,268933,129579,139354,2012.csv,2012,48.18263284907393,51.81736715092606
4394,The World Before Your Feet,268644,268644,0,2018.csv,2018,100.0,0.0
4395,Meri Pyaari Bindu,268067,0,268067,2017.csv,2017,0.0,100.0
4396,The Carer,267995,6208,261787,2016.csv,2016,2.3164611280061194,97.68353887199387
4397,Conan O'Brien Can't Stop,267965,267965,0,2011.csv,2011,100.0,0.0
4398,An American in Paris 2020 Re-release,267824,267824,0,2020.csv,2020,100.0,0.0
4399,Falcon Rising,267476,11774,255702,2014.csv,2014,4.401890263051638,95.59810973694837
4400,Munger Road,266689,266689,0,2011.csv,2011,100.0,0.0
4401,Never Rarely Sometimes Always,265938,16565,249373,2020.csv,2020,6.228895456835804,93.7711045431642
4402,Luzia: Cirque du Soleil in Cinema,265673,265673,0,2019.csv,2019,100.0,0.0
4403,Félicité,265495,12433,253062,2017.csv,2017,4.682950714702725,95.31704928529727
4404,Out of Liberty,265279,265279,0,2019.csv,2019,100.0,0.0
4405,"Asbury Park: Riot, Redemption, Rock & Roll",264983,167684,97299,2019.csv,2019,63.281040670533585,36.718959329466415
4406,Doctor Who,264629,264629,0,2018.csv,2018,100.0,0.0
4407,Phil Ochs: There But for Fortune,263723,263723,0,2011.csv,2011,100.0,0.0
4408,The Producers 2018 Re-release,263277,216807,46470,2018.csv,2018,82.34938866668946,17.650611333310543
4409,Grand départ,262412,677,261735,2013.csv,2013,0.25799125040013415,99.74200874959986
4410,Augustine,262390,107352,155038,2013.csv,2013,40.913144555813865,59.086855444186135
4411,The Final Year,262286,191900,70386,2018.csv,2018,73.16440831763799,26.835591682362004
4412,Minimalism: A Documentary About the Important Things,261865,261865,0,2016.csv,2016,100.0,0.0
4413,Any Day Now,261747,201395,60352,2012.csv,2012,76.94262016374591,23.057379836254093
4414,Half Girlfriend,261597,0,261597,2017.csv,2017,0.0,100.0
4415,Eating You Alive,260534,260534,0,2018.csv,2018,100.0,0.0
4416,Her Smell,260481,255599,4882,2019.csv,2019,98.1257750085419,1.8742249914581102
4417,Star Raiders: The Adventures of Saber Raine,260234,260234,0,2019.csv,2019,100.0,0.0
4418,The Cave,258921,62625,196296,2019.csv,2019,24.186914155282885,75.81308584471711
4419,The Unspoken,258760,0,258760,2016.csv,2016,0.0,100.0
4420,Across the Universe 2018 Re-release,258618,258618,0,2018.csv,2018,100.0,0.0
4421,Big 2018 Re-release,258507,258507,0,2018.csv,2018,100.0,0.0
4422,The Music Never Stopped,258223,258223,0,2011.csv,2011,100.0,0.0
4423,Mysteries of Lisbon,257065,110507,146558,2010.csv,2010,42.987960243518174,57.012039756481826
4424,Spiders,257019,0,257019,2013.csv,2013,0.0,100.0
4425,Raja Natwarlal,256978,131105,125873,2014.csv,2014,51.01798597545315,48.98201402454685
4426,Helicopter Eela,256952,71971,184981,2018.csv,2018,28.00951150409415,71.99048849590585
4427,Alive Inside: A Story of Music and Memory,256682,256682,0,2014.csv,2014,100.0,0.0
4428,Jean-Michel Basquiat: The Radiant Child,256242,256242,0,2010.csv,2010,100.0,0.0
4429,Officer Down,255080,1463,253617,2013.csv,2013,0.5735455543358946,99.4264544456641
4430,Dean,254536,254536,0,2017.csv,2017,100.0,0.0
4431,The Robber,254489,83451,171038,2010.csv,2010,32.791594135699384,67.20840586430062
4432,Fall in Love Like a Star 2015 Re-release,253785,212508,41277,2015.csv,2015,83.73544535729062,16.26455464270938
4433,Mistaken for Strangers,253285,138991,114294,2014.csv,2014,54.875338057918945,45.124661942081055
4434,Battlefield America,252805,172000,80805,2012.csv,2012,68.03662902236903,31.96337097763098
4435,Play the Flute,252572,252572,0,2019.csv,2019,100.0,0.0
4436,When Harry Met Sally... 30th Anniversary,252320,252320,0,2019.csv,2019,100.0,0.0
4437,I Got the Hook Up 2,252293,252293,0,2019.csv,2019,100.0,0.0
4438,The Human Centipede (First Sequence),252207,181467,70740,2010.csv,2010,71.95161117653356,28.048388823466436
4439,Caterpillar,251922,4157,247765,2010.csv,2010,1.650113924151126,98.34988607584887
4440,Canal Street,251917,251917,0,2019.csv,2019,100.0,0.0
4441,Gook,251541,250130,1411,2017.csv,2017,99.4390576486537,0.5609423513463014
4442,The Twilight Zone: A 60th Anniversary Celebration,248514,248514,0,2019.csv,2019,100.0,0.0
4443,Band Aid,248370,248370,0,2017.csv,2017,100.0,0.0
4444,The Attacks of 26/11,248346,248346,0,2013.csv,2013,100.0,0.0
4445,Wild Oats,247949,40598,207351,2016.csv,2016,16.37352842721689,83.62647157278312
4446,Doctor Who: The End of Time: Part One,247798,247798,0,2019.csv,2019,100.0,0.0
4447,Lilting,247377,27054,220323,2014.csv,2014,10.936344122533622,89.06365587746637
4448,The Galapagos Affair: Satan Came to Eden,247159,247159,0,2014.csv,2014,100.0,0.0
4449,My Dog Tulip,246574,246574,0,2010.csv,2010,100.0,0.0
4450,The Notebook 2013 Re-release,246557,66559,179998,2013.csv,2013,26.99538037857372,73.00461962142629
4451,The Love Witch,246218,228894,17324,2016.csv,2016,92.96395876824603,7.036041231753974
4452,Friendsgiving Day #1,246168,246168,0,2019.csv,2019,100.0,0.0
4453,Hot Summer Nights,246133,0,246133,2018.csv,2018,0.0,100.0
4454,"Tuesday, After Christmas",245833,27813,218020,2010.csv,2010,11.31377805258041,88.68622194741958
4455,Harry Potter and the Chamber of Secrets 2018 Re-release,245501,245501,0,2018.csv,2018,100.0,0.0
4456,American Woman,245416,236637,8779,2019.csv,2019,96.42280861883495,3.577191381165042
4457,The Fireflies Are Gone,245006,245006,0,2018.csv,2018,100.0,0.0
4458,The Waiting Room,244951,244951,0,2012.csv,2012,100.0,0.0
4459,Term Life,243793,21256,222537,2016.csv,2016,8.718872157937266,91.28112784206273
4460,My Uncle Rafael,243616,243616,0,2012.csv,2012,100.0,0.0
4461,Rangeelay,243246,148418,94828,2013.csv,2013,61.01559737878526,38.984402621214734
4462,Out of Blue,242847,18779,224068,2019.csv,2019,7.732852372069657,92.26714762793034
4463,My Perestroika,242707,242707,0,2011.csv,2011,100.0,0.0
4464,Tevar,242453,236002,6451,2015.csv,2015,97.33927812813205,2.6607218718679495
4465,Archive,242195,139593,102602,2020.csv,2020,57.63661512417681,42.3633848758232
4466,Ophelia,242115,50722,191393,2019.csv,2019,20.94954876814737,79.05045123185263
4467,Brotherhood,240887,8979,231908,2010.csv,2010,3.727473877793322,96.27252612220668
4468,Road to Ninja - Naruto the Movie 2014 Re-release,240687,43171,197516,2014.csv,2014,17.93657322580779,82.06342677419221
4469,Boulevard,240450,126150,114300,2015.csv,2015,52.46412975670618,47.53587024329383
4470,Carter High,240214,240214,0,2015.csv,2015,100.0,0.0
4471,Of Horses and Men,239969,11894,228075,2013.csv,2013,4.956473544499498,95.0435264555005
4472,Dark River,239182,7714,231468,2018.csv,2018,3.225159083877549,96.77484091612246
4473,311 Enlarged to Show Detail 3,238791,238791,0,2019.csv,2019,100.0,0.0
4474,Crown Heights,238558,238558,0,2017.csv,2017,100.0,0.0
4475,RWBY: Argus Limited,238379,238379,0,2018.csv,2018,100.0,0.0
4476,Red Obsession,238223,13199,225024,2013.csv,2013,5.540606910331916,94.45939308966808
4477,American Satan,237708,237708,0,2017.csv,2017,100.0,0.0
4478,Tokyo Godfathers 2020 Re-release,237571,237571,0,2020.csv,2020,100.0,0.0
4479,The Trip to Greece,237473,8340,229133,2020.csv,2020,3.51197820383791,96.48802179616209
4480,Alien Intrusion: Unmasking a Deception,237411,237411,0,2018.csv,2018,100.0,0.0
4481,Shuddh Desi Romance,237249,0,237249,2013.csv,2013,0.0,100.0
4482,Middle of Nowhere,236806,236806,0,2012.csv,2012,100.0,0.0
4483,India's Most Wanted,235351,176858,58493,2019.csv,2019,75.14648333765312,24.853516662346877
4484,Varda by Agnès,235262,160765,74497,2019.csv,2019,68.3344526527871,31.665547347212897
4485,The Exorcist Extended Director's Cut,235134,235134,0,2010.csv,2010,100.0,0.0
4486,Diamantino,235041,70088,164953,2018.csv,2018,29.819478303785296,70.1805216962147
4487,Art and Craft,235037,235037,0,2014.csv,2014,100.0,0.0
4488,Blind Eyes Opened,234505,234505,0,2020.csv,2020,100.0,0.0
4489,After the Ball,234417,161820,72597,2015.csv,2015,69.03082967532218,30.96917032467782
4490,Little Shop of Horrors 2017 Re-release,233865,233865,0,2017.csv,2017,100.0,0.0
4491,Superman 2018 Re-release,233585,233585,0,2018.csv,2018,100.0,0.0
4492,Premier Boxing Champions: PBC on FOX: Spence vs. Porter,232973,232973,0,2019.csv,2019,100.0,0.0
4493,Lost and Found in Armenia,232857,122305,110552,2012.csv,2012,52.52365185500114,47.476348144998866
4494,Bishôjo senshi Sailor Moon Super S Special,231434,231434,0,2018.csv,2018,100.0,0.0
4495,A Place at the Table,231378,231378,0,2013.csv,2013,100.0,0.0
4496,DAZN Boxing: Canelo Alvarez vs. Daniel Jacobs,230703,230703,0,2019.csv,2019,100.0,0.0
4497,"Life, Above All",230529,134461,96068,2011.csv,2011,58.327151898459626,41.672848101540374
4498,Shirley,230441,0,230441,2020.csv,2020,0.0,100.0
4499,Chakravyuh,230136,151778,78358,2012.csv,2012,65.95143741092224,34.04856258907776
4500,"Belle and Sebastian, Friends for Life 2018 Re-release",229983,105890,124093,2018.csv,2018,46.04253357856885,53.95746642143114
4501,Wrecked,229532,8020,221512,2011.csv,2011,3.4940661868497638,96.50593381315024
4502,The Last Tree,228676,10128,218548,2019.csv,2019,4.428973744511886,95.5710262554881
4503,Doctor Who Live Q&A And Screening,228615,228615,0,2020.csv,2020,100.0,0.0
4504,City of Ghosts,228225,128015,100210,2017.csv,2017,56.0915762953226,43.9084237046774
4505,Jeremiah Tower: The Last Magnificent,228153,228153,0,2017.csv,2017,100.0,0.0
4506,InAPPropriate Comedy,228004,228004,0,2013.csv,2013,100.0,0.0
4507,Like Water,227332,0,227332,2012.csv,2012,0.0,100.0
4508,Studio 54,227062,199767,27295,2018.csv,2018,87.9790541790348,12.0209458209652
4509,Mine 9,226421,226421,0,2019.csv,2019,100.0,0.0
4510,Rumble: The Indians Who Rocked The World,226006,226006,0,2017.csv,2017,100.0,0.0
4511,Dr. Cabbie,225490,225490,0,2014.csv,2014,100.0,0.0
4512,Millennium Actress 2019 Re-release,225250,225250,0,2019.csv,2019,100.0,0.0
4513,The Black Waters of Echo's Pond,224409,224409,0,2010.csv,2010,100.0,0.0
4514,Experimenter,224145,155575,68570,2015.csv,2015,69.40819558767762,30.591804412322382
4515,Tampopo,224097,224097,0,2016.csv,2016,100.0,0.0
4516,Extra Ordinary,223898,164346,59552,2019.csv,2019,73.40217420432519,26.59782579567482
4517,Premier Boxing Champions: PBC on FOX PPV: Pacquiao vs. Thurman,223858,223858,0,2019.csv,2019,100.0,0.0
4518,Crystal Fairy & the Magical Cactus,223821,202370,21451,2013.csv,2013,90.4160020730852,9.583997926914812
4519,BuyBust,223720,178471,45249,2018.csv,2018,79.77427141069194,20.225728589308066
4520,Tim and Eric's Billion Dollar Movie,223580,201436,22144,2012.csv,2012,90.09571518024867,9.904284819751318
4521,Take Every Wave: The Life of Laird Hamilton,223301,176076,47225,2017.csv,2017,78.85141580198925,21.148584198010756
4522,Never Surrender: A Galaxy Quest Documentary,222971,222971,0,2019.csv,2019,100.0,0.0
4523,Spirit of the Game,222565,222565,0,2016.csv,2016,100.0,0.0
4524,10.000 Km,222530,12423,210107,2014.csv,2014,5.582618073967555,94.41738192603243
4525,Film socialisme,222079,42925,179154,2010.csv,2010,19.32870735188829,80.6712926481117
4526,High School,221590,139034,82556,2012.csv,2012,62.743806128435395,37.256193871564605
4527,Neil Young Journeys,221082,215026,6056,2012.csv,2012,97.2607448819895,2.739255118010512
4528,Phantom Boy,221016,34362,186654,2015.csv,2015,15.547290693886415,84.45270930611358
4529,Little Pink House,220948,220948,0,2018.csv,2018,100.0,0.0
4530,Chance Pe Dance,220619,168643,51976,2010.csv,2010,76.44083238524334,23.559167614756664
4531,Supermensch,220065,213064,7001,2014.csv,2014,96.8186672119601,3.181332788039897
4532,Great Performances at the Met: Puccini: Turandot,219619,172627,46992,2016.csv,2016,78.60294418971037,21.39705581028964
4533,Brooklyn Castle,219407,219407,0,2012.csv,2012,100.0,0.0
4534,Fragments of Truth,219342,219342,0,2018.csv,2018,100.0,0.0
4535,Club Life,219229,4444,214785,2015.csv,2015,2.0271040783837906,97.97289592161621
4536,The House I Live In,219159,210752,8407,2012.csv,2012,96.16397227583626,3.836027724163735
4537,Harry Potter and the Prisoner of Azkaban 2018 Re-release,218774,218774,0,2018.csv,2018,100.0,0.0
4538,California Typewriter,218563,218563,0,2017.csv,2017,100.0,0.0
4539,Dark Money,217932,217932,0,2018.csv,2018,100.0,0.0
4540,Getting Grace,217812,217812,0,2018.csv,2018,100.0,0.0
4541,Jane's Journey,217615,27253,190362,2010.csv,2010,12.523493325368197,87.4765066746318
4542,Complete Unknown,217473,191761,25712,2016.csv,2016,88.1769231122944,11.8230768877056
4543,The Karate Kid 2019 Re-release,215447,215447,0,2019.csv,2019,100.0,0.0
4544,The Treasure of the Sierra Madre,215295,215295,0,2018.csv,2018,100.0,0.0
4545,The Tribe,215034,150564,64470,2015.csv,2015,70.01869471804459,29.98130528195541
4546,Risk,214669,200219,14450,2017.csv,2017,93.26870670660412,6.731293293395879
4547,Hamlet 2019 Re-release,214578,214578,0,2019.csv,2019,100.0,0.0
4548,The Pervert's Guide to Ideology,214313,67966,146347,2013.csv,2013,31.713428490105596,68.28657150989442
4549,Ingrid Bergman: In Her Own Words,214014,138148,75866,2015.csv,2015,64.55091722971395,35.449082770286054
4550,Marjorie Prime,213858,180608,33250,2017.csv,2017,84.4523001243816,15.5476998756184
4551,Thaandavam,213476,213476,0,2012.csv,2012,100.0,0.0
4552,The Wound,213043,30678,182365,2017.csv,2017,14.399909877348705,85.6000901226513
4553,The Afflicted,212940,212940,0,2011.csv,2011,100.0,0.0
4554,Chocolate City,212662,212662,0,2015.csv,2015,100.0,0.0
4555,Young & Wild,212624,5514,207110,2012.csv,2012,2.5933102566032056,97.4066897433968
4556,Big Sonia,212471,212471,0,2017.csv,2017,100.0,0.0
4557,Fatima,212228,50105,162123,2016.csv,2016,23.609043104585634,76.39095689541436
4558,Donnie Darko 2016 Re-release,212034,207971,4063,2016.csv,2016,98.08379788147184,1.9162021185281608
4559,Somewhere Between,210975,210975,0,2012.csv,2012,100.0,0.0
4560,La soga,210625,210625,0,2010.csv,2010,100.0,0.0
4561,A Glimpse Inside the Mind of Charles Swan III,210565,45350,165215,2013.csv,2013,21.53729252249899,78.46270747750101
4562,Tigers Are Not Afraid 2019 Re-release,210138,175559,34579,2019.csv,2019,83.54462305722906,16.45537694277094
4563,Beware of Mr. Baker,210123,116476,93647,2012.csv,2012,55.43229441803135,44.56770558196866
4564,"Faith, Hope & Love",210091,210091,0,2019.csv,2019,100.0,0.0
4565,House,209765,209765,0,2010.csv,2010,100.0,0.0
4566,The Death of Louis XIV,209715,43635,166080,2016.csv,2016,20.80680924111294,79.19319075888707
4567,Rob the Mob,209613,208693,920,2014.csv,2014,99.56109592439401,0.4389040756059977
4568,SEED: The Untold Story,209580,207825,1755,2016.csv,2016,99.16261093615803,0.8373890638419695
4569,Kathy Griffin: A Hell of a Story,208907,208907,0,2019.csv,2019,100.0,0.0
4570,Casablanca 2013 Re-release,208608,208608,0,2013.csv,2013,100.0,0.0
4571,Agent Mr. Chan,208351,208351,0,2018.csv,2018,100.0,0.0
4572,The Right Kind of Wrong,208105,2098,206007,2014.csv,2014,1.0081449268398164,98.99185507316018
4573,The Dating Project,208100,208100,0,2018.csv,2018,100.0,0.0
4574,Batman 2019 Re-release,207901,159419,48482,2019.csv,2019,76.6802468482595,23.319753151740493
4575,Under the Electric Sky,207584,207584,0,2014.csv,2014,100.0,0.0
4576,Heading Home: The Tale of Team Israel,207533,207533,0,2018.csv,2018,100.0,0.0
4577,Sweetgrass,207473,207473,0,2010.csv,2010,100.0,0.0
4578,Advanced Style,207231,87879,119352,2014.csv,2014,42.40630021570132,57.59369978429868
4579,Ek Thi Daayan,206279,112135,94144,2013.csv,2013,54.36084138472651,45.63915861527349
4580,Don't Call Me Son,205987,11678,194309,2016.csv,2016,5.669289809551088,94.33071019044891
4581,The Desert Bride,205350,30110,175240,2017.csv,2017,14.662770878987095,85.3372291210129
4582,Sicilian Ghost Story,204892,15285,189607,2017.csv,2017,7.460027721921793,92.53997227807821
4583,The Iron Orchard,204881,204881,0,2019.csv,2019,100.0,0.0
4584,Working Woman,204727,64048,140679,2019.csv,2019,31.28458874501165,68.71541125498834
4585,Hesburgh,204709,204709,0,2019.csv,2019,100.0,0.0
4586,Pop Aye,204464,77976,126488,2017.csv,2017,38.13678691603412,61.86321308396588
4587,Touchback,204232,204232,0,2012.csv,2012,100.0,0.0
4588,Forrest Gump 2019 Re-release,203088,203088,0,2019.csv,2019,100.0,0.0
4589,Charlie's Country,202966,42937,160029,2014.csv,2014,21.15477469132761,78.84522530867238
4590,Keep the Change,202788,202788,0,2018.csv,2018,100.0,0.0
4591,"Filth to Ashes, Flesh to Dust",202531,202531,0,2011.csv,2011,100.0,0.0
4592,The Bolshoi Ballet: Live From Moscow - Coppélia,202217,202217,0,2018.csv,2018,100.0,0.0
4593,"Hieronymus Bosch, Touched by the Devil",201907,172533,29374,2016.csv,2016,85.45171787010851,14.548282129891485
4594,The Bad Batch,201890,180851,21039,2017.csv,2017,89.57897865174105,10.421021348258954
4595,Blink of an Eye,201874,201874,0,2019.csv,2019,100.0,0.0
4596,Zombi Child,200909,25878,175031,2019.csv,2019,12.880458316949465,87.11954168305054
4597,Legendary,200393,200393,0,2010.csv,2010,100.0,0.0
4598,Gemini,200340,200340,0,2018.csv,2018,100.0,0.0
4599,White Girl,200242,200242,0,2016.csv,2016,100.0,0.0
4600,No Place on Earth,200238,200238,0,2013.csv,2013,100.0,0.0
4601,9/11,200229,170000,30229,2017.csv,2017,84.90278630967542,15.09721369032458
4602,Listen Up Philip,200126,200126,0,2014.csv,2014,100.0,0.0
4603,Cutie and the Boxer,200036,200036,0,2013.csv,2013,100.0,0.0
4604,Rebel Without a Cause 2018 Re-release,199963,199963,0,2018.csv,2018,100.0,0.0
4605,The Fallen Idol 2016 Re-release,199619,199619,0,2016.csv,2016,100.0,0.0
4606,October Baby,199442,199442,0,2011.csv,2011,100.0,0.0
4607,Friendsgiving Day #2,198869,198869,0,2019.csv,2019,100.0,0.0
4608,Little Joe,198674,23862,174812,2019.csv,2019,12.01063048008295,87.98936951991705
4609,The Warrior Queen of Jhansi,198544,177289,21255,2019.csv,2019,89.29456442904343,10.705435570956563
4610,Ex Libris: New York Public Library,198239,158192,40047,2017.csv,2017,79.79862690994204,20.201373090057963
4611,A Summer's Tale,198126,198126,0,2014.csv,2014,100.0,0.0
4612,Whores' Glory,197932,31420,166512,2011.csv,2011,15.874138593052159,84.12586140694785
4613,Pusher,197857,0,197857,2012.csv,2012,0.0,100.0
4614,Madeline's Madeline,197309,185576,11733,2018.csv,2018,94.05348970396687,5.946510296033126
4615,Have It All -The Movie,197142,197142,0,2018.csv,2018,100.0,0.0
4616,Mom,195701,0,195701,2017.csv,2017,0.0,100.0
4617,Boom for Real: The Late Teenage Years of Jean-Michel Basquiat,195517,166616,28901,2018.csv,2018,85.21816517233796,14.781834827662044
4618,The Divine Order,195081,76277,118804,2017.csv,2017,39.100168647894975,60.899831352105025
4619,Free Angela and All Political Prisoners,195005,194102,903,2013.csv,2013,99.5369349503859,0.4630650496141125
4620,Family,194601,194601,0,2019.csv,2019,100.0,0.0
4621,A Screaming Man,193981,9862,184119,2010.csv,2010,5.08400307246586,94.91599692753414
4622,Mr. Klein,193028,193028,0,2019.csv,2019,100.0,0.0
4623,Client 9: The Rise and Fall of Eliot Spitzer,192870,189416,3454,2010.csv,2010,98.2091564266086,1.7908435733914034
4624,Claire's Camera,191980,83418,108562,2018.csv,2018,43.45140118762371,56.54859881237629
4625,Harry Potter and the Deathly Hallows: Part 2 2018 Re-release,191886,181938,9948,2018.csv,2018,94.8156718051343,5.184328194865701
4626,Past Life,191678,180099,11579,2017.csv,2017,93.9591398073853,6.040860192614698
4627,Chalo Dilli,191185,94300,96885,2011.csv,2011,49.32395323900934,50.676046760990666
4628,The Romantics,191019,106524,84495,2010.csv,2010,55.766180327611394,44.233819672388606
4629,Digimon Adventure tri. Part 1: Reunion Domestic Release,190581,190581,0,2016.csv,2016,100.0,0.0
4630,Code Black,190229,190229,0,2014.csv,2014,100.0,0.0
4631,The Doors: Break On Thru - A Celebration Of Ray Manzarek,190160,190160,0,2020.csv,2020,100.0,0.0
4632,The Divine Plan,190031,190031,0,2019.csv,2019,100.0,0.0
4633,Java Heat,189739,1061,188678,2013.csv,2013,0.5591892020090756,99.44081079799092
4634,Munna Michael,189105,99629,89476,2017.csv,2017,52.68448745405991,47.31551254594009
4635,Nick Saban: Gamechanger,189000,189000,0,2010.csv,2010,100.0,0.0
4636,Harry Potter and the Goblet of Fire 2018 Re-release,188716,188716,0,2018.csv,2018,100.0,0.0
4637,Leap Year,188242,12979,175263,2010.csv,2010,6.894848121035688,93.1051518789643
4638,The Bolshoi Ballet: Live From Moscow - Don Quixote,187946,187946,0,2018.csv,2018,100.0,0.0
4639,Never-Ending Man: Hayao Miyazaki,187320,187320,0,2018.csv,2018,100.0,0.0
4640,The Last Days on Mars,187191,24084,163107,2013.csv,2013,12.866003173229482,87.13399682677053
4641,In the Fog,186838,11894,174944,2013.csv,2013,6.365942688318222,93.63405731168177
4642,Good for Nothing,186119,0,186119,2012.csv,2012,0.0,100.0
4643,Twiceland,186078,52874,133204,2018.csv,2018,28.414965767043928,71.58503423295606
4644,Salt of This Sea 2010 Re-release,186045,11662,174383,2010.csv,2010,6.268375930554436,93.73162406944556
4645,In the Basement,186036,3643,182393,2014.csv,2014,1.9582231396073877,98.04177686039262
4646,Britt-Marie Was Here,185794,36549,149245,2019.csv,2019,19.671787032950473,80.32821296704952
4647,Buñuel in the Labyrinth of the Turtles,185675,36205,149470,2019.csv,2019,19.499124814864683,80.50087518513531
4648,The Duke of Burgundy,185147,64521,120626,2015.csv,2015,34.84852576601295,65.15147423398705
4649,Cobra Kai Premiere Event feat. The Karate Kid,185082,185082,0,2018.csv,2018,100.0,0.0
4650,The Wolf of Snow Hollow,185026,185026,0,2020.csv,2020,100.0,0.0
4651,Amigo,184705,184705,0,2011.csv,2011,100.0,0.0
4652,To Dust,184495,184495,0,2019.csv,2019,100.0,0.0
4653,Score,184025,101382,82643,2017.csv,2017,55.091427795136525,44.90857220486347
4654,The River and the Wall,183602,183602,0,2019.csv,2019,100.0,0.0
4655,"The Man Nobody Knew: In Search of My Father, CIA Spymaster William Colby",183342,183342,0,2011.csv,2011,100.0,0.0
4656,Lambert & Stamp,183320,183320,0,2015.csv,2015,100.0,0.0
4657,Whose Streets?,182799,182799,0,2017.csv,2017,100.0,0.0
4658,The Masked Saint,182695,182695,0,2016.csv,2016,100.0,0.0
4659,I Am Not A Witch,182462,50868,131594,2017.csv,2017,27.87868158849514,72.12131841150486
4660,Shock and Awe,182415,77980,104435,2018.csv,2018,42.748677466217146,57.251322533782854
4661,Giant Little Ones,181507,181507,0,2019.csv,2019,100.0,0.0
4662,Bolshoi Ballet: Raymonda domestic,181361,181361,0,2019.csv,2019,100.0,0.0
4663,Raymonda: Bolshoi Ballet,181361,181361,0,2019.csv,2019,100.0,0.0
4664,Rafiki,181316,137968,43348,2019.csv,2019,76.09256767190982,23.907432328090188
4665,Six Minutes to Midnight,181216,0,181216,2020.csv,2020,0.0,100.0
4666,Winnebago Man,181039,181039,0,2010.csv,2010,100.0,0.0
4667,1001 Grams,181030,10983,170047,2014.csv,2014,6.066950229243772,93.93304977075623
4668,An Honest Liar,180590,180590,0,2015.csv,2015,100.0,0.0
4669,Fukrey,180331,125279,55052,2013.csv,2013,69.4716937187727,30.528306281227298
4670,Go for It!,180237,180237,0,2011.csv,2011,100.0,0.0
4671,Lost Woods,180117,180117,0,2012.csv,2012,100.0,0.0
4672,Lila & Eve,179807,38263,141544,2015.csv,2015,21.280039153091927,78.71996084690808
4673,Offender,178158,0,178158,2012.csv,2012,0.0,100.0
4674,Walking on Water,178119,102140,75979,2019.csv,2019,57.343685962755245,42.65631403724476
4675,Modest Heroes,178027,178027,0,2019.csv,2019,100.0,0.0
4676,Zaytoun,177753,42330,135423,2013.csv,2013,23.81394406845454,76.18605593154545
4677,Monumental: In Search of America's National Treasure,177729,177729,0,2012.csv,2012,100.0,0.0
4678,Nostalgia for the Light,177634,163962,13672,2010.csv,2010,92.30327527387774,7.696724726122252
4679,Billie,177602,0,177602,2020.csv,2020,0.0,100.0
4680,People Places Things,177338,67046,110292,2015.csv,2015,37.80689981842583,62.19310018157417
4681,Anita: Speaking Truth to Power,176979,176979,0,2014.csv,2014,100.0,0.0
4682,Bye Bye Germany,176933,73730,103203,2017.csv,2017,41.67114105339309,58.32885894660691
4683,Casino Jack and the United States of Money,176865,176865,0,2010.csv,2010,100.0,0.0
4684,Anchor Baby,176784,15790,160994,2010.csv,2010,8.931803783147796,91.0681962168522
4685,Vigilante Diaries,176777,1991,174786,2016.csv,2016,1.126277739751212,98.87372226024878
4686,"Iyengar: The Man, Yoga, and the Student's Journey",176387,176387,0,2019.csv,2019,100.0,0.0
4687,Better Watch Out,176288,20369,155919,2017.csv,2017,11.55438827373389,88.44561172626611
4688,Girl on a Bicycle,176272,91401,84871,2013.csv,2013,51.85225106653354,48.14774893346646
4689,Saint Judy,176196,78935,97261,2019.csv,2019,44.799541419782514,55.20045858021748
4690,The Bolshoi Ballet: Live From Moscow - The Flames of Paris,175922,175922,0,2018.csv,2018,100.0,0.0
4691,Afternoon Delight,175755,174496,1259,2013.csv,2013,99.28366191573497,0.716338084265028
4692,Butter,175706,105018,70688,2012.csv,2012,59.76915984656187,40.23084015343813
4693,A.C.O.D.,175705,175705,0,2013.csv,2013,100.0,0.0
4694,Black Rock,175682,0,175682,2013.csv,2013,0.0,100.0
4695,Champion,175232,175232,0,2017.csv,2017,100.0,0.0
4696,Apparition,175038,0,175038,2019.csv,2019,0.0,100.0
4697,Always at The Carlyle,174251,174251,0,2018.csv,2018,100.0,0.0
4698,SOMM,174197,174197,0,2013.csv,2013,100.0,0.0
4699,Grand Illusion,174065,174065,0,2012.csv,2012,100.0,0.0
4700,Elf 2020 Re-release,173568,173568,0,2020.csv,2020,100.0,0.0
4701,Neon Bull,173219,26734,146485,2016.csv,2016,15.433641806037443,84.56635819396256
4702,Cirkus Columbia,173083,3457,169626,2011.csv,2011,1.9973076500869527,98.00269234991305
4703,Them That Follow,172952,159218,13734,2019.csv,2019,92.05906841204497,7.94093158795504
4704,Bellflower,172935,168226,4709,2011.csv,2011,97.27701159395149,2.7229884060485157
4705,Afternoon of a Faun: Tanaquil Le Clercq,172450,172450,0,2014.csv,2014,100.0,0.0
4706,All Things Must Pass,172394,172394,0,2015.csv,2015,100.0,0.0
4707,Escape from Tomorrow,171962,171962,0,2013.csv,2013,100.0,0.0
4708,Little Woods,171912,150010,21902,2019.csv,2019,87.25976080785517,12.740239192144816
4709,Copperhead,171740,171740,0,2013.csv,2013,100.0,0.0
4710,Abuse of Weakness,171660,31611,140049,2014.csv,2014,18.41488989863684,81.58511010136316
4711,United Passions,171511,607,170904,2014.csv,2014,0.3539131600888573,99.64608683991113
4712,The Bolshoi Ballet: Live From Moscow - La Sylphide,171177,171177,0,2018.csv,2018,100.0,0.0
4713,Palau the Movie,171155,134696,36459,2019.csv,2019,78.6982559668137,21.301744033186292
4714,Cheerful Weather for the Wedding,170922,2651,168271,2012.csv,2012,1.5509998712863178,98.44900012871368
4715,Apparition Hill,170457,170457,0,2016.csv,2016,100.0,0.0
4716,The Human Centipede II (Full Sequence),170323,141877,28446,2011.csv,2011,83.29879112040065,16.70120887959935
4717,The House That Jack Built,170113,170113,0,2018.csv,2018,100.0,0.0
4718,The Fits,169236,166425,2811,2016.csv,2016,98.33900588527264,1.660994114727363
4719,Viva Riva!,168982,61759,107223,2011.csv,2011,36.54767963451729,63.45232036548272
4720,Free the Mind,168916,157201,11715,2013.csv,2013,93.0646001562907,6.935399843709298
4721,Girls of the Sun,168771,19712,149059,2018.csv,2018,11.67973170746159,88.3202682925384
4722,Valley of Bones,168738,168738,0,2017.csv,2017,100.0,0.0
4723,We Summon the Darkness,168473,60794,107679,2020.csv,2020,36.0853074379871,63.91469256201291
4724,Be Natural: The Untold Story of Alice Guy-Blaché,168189,115804,52385,2019.csv,2019,68.85349220222487,31.146507797775126
4725,De Palma,168045,165237,2808,2016.csv,2016,98.32901901276443,1.6709809872355617
4726,The Clovehitch Killer,167994,8208,159786,2018.csv,2018,4.885888781742205,95.11411121825779
4727,The Bolshoi Ballet: Live From Moscow - The Lady of the Camellias,167991,167991,0,2018.csv,2018,100.0,0.0
4728,Perrier's Bounty,167938,828,167110,2010.csv,2010,0.49303909776226945,99.50696090223772
4729,The Comeback Trail,167818,0,167818,2020.csv,2020,0.0,100.0
4730,Beauty and the Dogs,167723,8915,158808,2017.csv,2017,5.315311555362115,94.68468844463789
4731,Genius Within: The Inner Life of Glenn Gould,167508,167508,0,2010.csv,2010,100.0,0.0
4732,Is Genesis History? 2018 Re-release,166763,166763,0,2018.csv,2018,100.0,0.0
4733,Grease 2020 Re-release,166123,102000,64123,2020.csv,2020,61.40028773860332,38.599712261396675
4734,The Day After,166022,24746,141276,2017.csv,2017,14.90525352061775,85.09474647938225
4735,Far From the Tree,166018,166018,0,2018.csv,2018,100.0,0.0
4736,Fool for Love,165987,165987,0,2010.csv,2010,100.0,0.0
4737,The Film Critic,165891,7358,158533,2014.csv,2014,4.435442549625959,95.56455745037404
4738,Bright Ones,165627,165627,0,2019.csv,2019,100.0,0.0
4739,2001: A Space Odyssey 2019 Re-release,165494,135370,30124,2019.csv,2019,81.79752740280615,18.202472597193857
4740,Christmas Eve,164839,91302,73537,2015.csv,2015,55.38859129210927,44.61140870789073
4741,Nas: Time Is Illmatic,164540,164540,0,2014.csv,2014,100.0,0.0
4742,The Chambermaid,164531,86422,78109,2019.csv,2019,52.526271644857204,47.4737283551428
4743,Eastern Boys,164290,16831,147459,2014.csv,2014,10.244689268975591,89.75531073102441
4744,Lost & Found,164026,125173,38853,2018.csv,2018,76.31290161315889,23.68709838684111
4745,Cruel Peter,163925,0,163925,2020.csv,2020,0.0,100.0
4746,Keep on Keepin' On,163745,163745,0,2014.csv,2014,100.0,0.0
4747,Narco Cultura,163690,145088,18602,2013.csv,2013,88.635836031523,11.364163968477
4748,Halston,163446,151991,11455,2019.csv,2019,92.99156908091969,7.008430919080308
4749,Walking Out,162445,101947,60498,2017.csv,2017,62.75785650527871,37.24214349472129
4750,The Turin Horse,162088,56391,105697,2011.csv,2011,34.790360791668725,65.20963920833127
4751,Road to Nowhere,161619,40294,121325,2011.csv,2011,24.931474640976617,75.06852535902338
4752,The Samuel Project,161565,161565,0,2018.csv,2018,100.0,0.0
4753,Lu Over the Wall,161253,109857,51396,2018.csv,2018,68.12710461200722,31.872895387992784
4754,Tharlo,161229,17091,144138,2016.csv,2016,10.600450291200715,89.39954970879928
4755,Spring Fever,161110,10824,150286,2010.csv,2010,6.718391161318355,93.28160883868165
4756,"Diana Ross: Her Life, Love and Legacy",160968,160968,0,2019.csv,2019,100.0,0.0
4757,National Theatre Live: The Curious Incident of the Dog in the Night-Time 2018 Re-release,160381,160381,0,2018.csv,2018,100.0,0.0
4758,Beauty and the Beast 2016 Re-release,160215,160215,0,2016.csv,2016,100.0,0.0
4759,Halloween 2020 Re-release,160000,160000,0,2020.csv,2020,100.0,0.0
4760,Sinbad: The Fifth Voyage,159862,159862,0,2014.csv,2014,100.0,0.0
4761,The Eclipse,159852,133411,26441,2010.csv,2010,83.45907464404574,16.540925355954258
4762,Murder 3,159798,0,159798,2013.csv,2013,0.0,100.0
4763,The Model,159743,0,159743,2016.csv,2016,0.0,100.0
4764,Eames: The Architect & The Painter,159715,153088,6627,2011.csv,2011,95.85073412015151,4.14926587984848
4765,The Body,159317,68196,91121,2019.csv,2019,42.805224803379424,57.194775196620576
4766,The Witness,159305,159305,0,2016.csv,2016,100.0,0.0
4767,We Are What We Are,159047,81381,77666,2013.csv,2013,51.16789376725119,48.832106232748814
4768,Until Forever,158872,35839,123033,2016.csv,2016,22.55841180321265,77.44158819678735
4769,The Last Resort,158646,158646,0,2018.csv,2018,100.0,0.0
4770,The Big Picture 2012 Re-release,158411,158411,0,2012.csv,2012,100.0,0.0
4771,Mother of George,157937,157937,0,2013.csv,2013,100.0,0.0
4772,The Look of Silence,157857,109089,48768,2015.csv,2015,69.1062163857162,30.893783614283816
4773,Crazy Horse,157782,157782,0,2012.csv,2012,100.0,0.0
4774,Hell and Back,157768,157768,0,2015.csv,2015,100.0,0.0
4775,A Call to Spy,157736,151929,5807,2020.csv,2020,96.31853223106963,3.6814677689303648
4776,Chasing Madoff,157612,157612,0,2011.csv,2011,100.0,0.0
4777,Eva Hesse,157481,157481,0,2016.csv,2016,100.0,0.0
4778,The Booksellers,157383,25694,131689,2020.csv,2020,16.325778514833242,83.67422148516675
4779,Suntan,157267,6643,150624,2016.csv,2016,4.224026655305944,95.77597334469405
4780,LUV,156996,156996,0,2013.csv,2013,100.0,0.0
4781,Marina Abramovic: The Artist Is Present,156695,86637,70058,2012.csv,2012,55.29021347203166,44.70978652796835
4782,Hatchet II,156190,52604,103586,2010.csv,2010,33.67949292528331,66.3205070747167
4783,Deadtime,156072,156072,0,2012.csv,2012,100.0,0.0
4784,Queen & Country,155881,41297,114584,2015.csv,2015,26.492645030504036,73.50735496949596
4785,Money,155732,155732,0,2019.csv,2019,100.0,0.0
4786,The Forgiveness of Blood,155383,126700,28683,2012.csv,2012,81.5404516581608,18.459548341839195
4787,The Boy and the World 2015 Re-release,155215,129480,25735,2015.csv,2015,83.41977257352704,16.580227426472955
4788,Western,155215,41072,114143,2018.csv,2018,26.461360048964337,73.53863995103566
4789,Magic Trip: Ken Kesey's Search for a Kool Place,155005,154521,484,2011.csv,2011,99.68775200799975,0.31224799200025805
4790,Bad Reputation,154190,148568,5622,2018.csv,2018,96.3538491471561,3.646150852843894
4791,Eating Animals,153993,149614,4379,2018.csv,2018,97.15636425032307,2.8436357496769333
4792,Citizen Koch,153908,153908,0,2014.csv,2014,100.0,0.0
4793,The Tag Along: Devil Fish,153895,20726,133169,2018.csv,2018,13.467624029370675,86.53237597062933
4794,Love Story 50th Anniversary,153504,153504,0,2020.csv,2020,100.0,0.0
4795,Harmonium,153283,17191,136092,2017.csv,2017,11.215203251502123,88.78479674849787
4796,Backstreet Boys: Show 'Em What You're Made Of,153068,153068,0,2015.csv,2015,100.0,0.0
4797,I Am Woman,152987,0,152987,2020.csv,2020,0.0,100.0
4798,In the Shadow of Women,152802,50291,102511,2015.csv,2015,32.9125273229408,67.0874726770592
4799,Deceptive Practice: The Mysteries and Mentors of Ricky Jay,152791,152791,0,2013.csv,2013,100.0,0.0
4800,Finding Fela,152346,120980,31366,2014.csv,2014,79.41133997610702,20.58866002389298
4801,The Call Up,152294,0,152294,2016.csv,2016,0.0,100.0
4802,Snake & Mongoose,152200,152200,0,2013.csv,2013,100.0,0.0
4803,One Week and a Day,152178,41614,110564,2016.csv,2016,27.345608432230676,72.65439156776932
4804,"Buttons, A New Musical Film",151983,151983,0,2018.csv,2018,100.0,0.0
4805,Born to Be Blue,151926,151926,0,2016.csv,2016,100.0,0.0
4806,Lupin the 3rd: Castle of Cagliostro 2017 Re-release,151802,142425,9377,2017.csv,2017,93.82287453393235,6.177125466067641
4807,Generation Found,151751,151751,0,2016.csv,2016,100.0,0.0
4808,Red Riding: The Year of Our Lord 1974,151644,151644,0,2010.csv,2010,100.0,0.0
4809,Before You Know It,151507,151507,0,2019.csv,2019,100.0,0.0
4810,Jay Myself,151331,151331,0,2019.csv,2019,100.0,0.0
4811,Revenge of the Electric Car,151272,150886,386,2011.csv,2011,99.74483050399282,0.25516949600719235
4812,The Cremaster Cycle 2010 Re-release,151239,151239,0,2010.csv,2010,100.0,0.0
4813,Glory 2019 Re-release,150801,150801,0,2019.csv,2019,100.0,0.0
4814,Tasting Menu,150718,18686,132032,2013.csv,2013,12.397988296023037,87.60201170397697
4815,Kicks,150191,150191,0,2016.csv,2016,100.0,0.0
4816,Godzilla 2014 Re-release,150191,150191,0,2014.csv,2014,100.0,0.0
4817,Nobody Else But You,150173,43040,107133,2011.csv,2011,28.660278478821095,71.33972152117892
4818,Only the Brave,150000,150000,0,2010.csv,2010,100.0,0.0
4819,Piercing,149211,15856,133355,2019.csv,2019,10.626562384810772,89.37343761518923
4820,Michael Moore in TrumpLand,149090,149090,0,2016.csv,2016,100.0,0.0
4821,Gun Hill Road,148994,148994,0,2011.csv,2011,100.0,0.0
4822,From Afar,148630,30169,118461,2016.csv,2016,20.29805557424477,79.70194442575523
4823,Trial by Fire,148504,148504,0,2019.csv,2019,100.0,0.0
4824,War and Peace,148503,148503,0,2019.csv,2019,100.0,0.0
4825,Harry Potter and the Deathly Hallows: Part 1 2018 Re-release,148263,148263,0,2010.csv,2010,100.0,0.0
4826,Restless Creature: Wendy Whelan,147780,147780,0,2017.csv,2017,100.0,0.0
4827,Night of the Living Dead 2018 Re-release,147423,147423,0,2018.csv,2018,100.0,0.0
4828,The Strange Case of Angelica,147173,50135,97038,2010.csv,2010,34.06535166097042,65.93464833902958
4829,Driven,147172,0,147172,2019.csv,2019,0.0,100.0
4830,Songs My Brothers Taught Me,146937,34793,112144,2015.csv,2015,23.678855563949174,76.32114443605083
4831,American Promise,146702,146702,0,2013.csv,2013,100.0,0.0
4832,Watermark,146572,84464,62108,2014.csv,2014,57.6262860573643,42.373713942635696
4833,Touched with Fire,146487,146487,0,2016.csv,2016,100.0,0.0
4834,5 Broken Cameras,146475,109983,36492,2012.csv,2012,75.08653353814644,24.91346646185356
4835,Hannah,146325,11700,134625,2018.csv,2018,7.9958995386981035,92.0041004613019
4836,Starlet,146222,88212,58010,2012.csv,2012,60.327447306150916,39.67255269384908
4837,Deadly Renovations,146146,146146,0,2012.csv,2012,100.0,0.0
4838,The Punk Singer,146000,122742,23258,2013.csv,2013,84.06986301369864,15.930136986301369
4839,Citizen K,145941,120411,25530,2019.csv,2019,82.50662939132938,17.493370608670627
4840,Framing John DeLorean,145625,145625,0,2019.csv,2019,100.0,0.0
4841,The Last Dalai Lama?,145524,145524,0,2017.csv,2017,100.0,0.0
4842,Krisha,144822,144822,0,2016.csv,2016,100.0,0.0
4843,Mr. Smith Goes to Washington 2018 Re-release,144738,144738,0,2018.csv,2018,100.0,0.0
4844,Wendy,144564,143518,1046,2020.csv,2020,99.2764450347251,0.7235549652748956
4845,Irving Berlin's Holiday Inn The Broadway Musical,144550,144550,0,2017.csv,2017,100.0,0.0
4846,The Price of Everything,144446,87400,57046,2018.csv,2018,60.50704069340792,39.492959306592084
4847,Yellow Day 2015 Re-release,144163,144163,0,2015.csv,2015,100.0,0.0
4848,From Beneath,144123,144123,0,2012.csv,2012,100.0,0.0
4849,Cold Weather,144056,141358,2698,2011.csv,2011,98.12711723218747,1.8728827678125175
4850,Thunder Soul,143986,143986,0,2011.csv,2011,100.0,0.0
4851,Cop Car,143658,134552,9106,2015.csv,2015,93.66133455846524,6.338665441534756
4852,Dirty Girl,143485,55125,88360,2011.csv,2011,38.418650033104505,61.581349966895495
4853,Doctor Who: Logopolis,143248,143248,0,2019.csv,2019,100.0,0.0
4854,Alpeis,143234,16057,127177,2012.csv,2012,11.21032715695994,88.78967284304005
4855,Survival of the Dead,143191,101740,41451,2010.csv,2010,71.05195158913618,28.948048410863812
4856,Kids for Cash,143178,143178,0,2014.csv,2014,100.0,0.0
4857,Clash,143121,18215,124906,2016.csv,2016,12.726993243479292,87.27300675652072
4858,Disguising,143108,0,143108,2018.csv,2018,0.0,100.0
4859,Dragon 2012 Re-release,142029,11137,130892,2012.csv,2012,7.84135634271874,92.15864365728126
4860,John Dies at the End,141951,141951,0,2013.csv,2013,100.0,0.0
4861,Citadel,141886,13377,128509,2012.csv,2012,9.427991486122663,90.57200851387734
4862,May in the Summer,141605,22004,119601,2014.csv,2014,15.538999329119735,84.46100067088027
4863,Best F(r)iends Volume Two,141524,141524,0,2018.csv,2018,100.0,0.0
4864,The Silencing,141479,100746,40733,2020.csv,2020,71.20915471554082,28.790845284459177
4865,Fatman,141235,141235,0,2020.csv,2020,100.0,0.0
4866,Branagh Theatre Live: The Winter's Tale,141143,141143,0,2019.csv,2019,100.0,0.0
4867,Metropolis Giorgio Moroder Presents,140907,27362,113545,2011.csv,2011,19.418481693599325,80.58151830640068
4868,Canelo vs. Kovalev,140820,140820,0,2019.csv,2019,100.0,0.0
4869,The Cordillera of Dreams,140465,20943,119522,2019.csv,2019,14.909763998149007,85.090236001851
4870,Incitement,140306,140306,0,2020.csv,2020,100.0,0.0
4871,Gore Vidal: The United States of Amnesia,140164,140164,0,2014.csv,2014,100.0,0.0
4872,Beautiful Boy,140123,77247,62876,2011.csv,2011,55.12799469037917,44.87200530962083
4873,The Weathered Underground,140091,140091,0,2010.csv,2010,100.0,0.0
4874,Liv & Ingmar,140041,10347,129694,2012.csv,2012,7.388550495926192,92.6114495040738
4875,Coherence,139745,102617,37128,2014.csv,2014,73.43160757093277,26.568392429067227
4876,Hunky Dory,139653,20296,119357,2012.csv,2012,14.533164343050275,85.46683565694973
4877,Support the Girls,139550,129124,10426,2018.csv,2018,92.52884270870656,7.4711572912934425
4878,Flowers,139421,61568,77853,2014.csv,2014,44.15977506975277,55.84022493024724
4879,Wilder vs. Ortiz,139207,139207,0,2019.csv,2019,100.0,0.0
4880,Xenia,139186,3181,136005,2014.csv,2014,2.285431005991982,97.71456899400802
4881,The Polar Express 2014 IMAX Release,139055,139055,0,2014.csv,2014,100.0,0.0
4882,Who Will Write Our History,138868,138039,829,2019.csv,2019,99.40303021574445,0.596969784255552
4883,Head Full of Honey,138844,12350,126494,2018.csv,2018,8.89487482354297,91.10512517645704
4884,Good Ol' Freda,138811,138811,0,2013.csv,2013,100.0,0.0
4885,Zero Motivation,138609,116044,22565,2014.csv,2014,83.72039333665202,16.279606663347977
4886,The Brawler,138515,75929,62586,2018.csv,2018,54.8164458722882,45.1835541277118
4887,Psycho-Pass: The Movie,138366,138366,0,2016.csv,2016,100.0,0.0
4888,Most Wanted,138000,138000,0,2020.csv,2020,100.0,0.0
4889,Lynryd Skynyrd: Last of the Street Survivors Farewell Tour,137888,137888,0,2019.csv,2019,100.0,0.0
4890,Love Ranch,137885,137885,0,2010.csv,2010,100.0,0.0
4891,Beneath Us,137260,137260,0,2020.csv,2020,100.0,0.0
4892,Is the Man Who Is Tall Happy?,137042,137042,0,2013.csv,2013,100.0,0.0
4893,Slaughter Creek,136815,136815,0,2012.csv,2012,100.0,0.0
4894,Made in Abyss: Journey's Dawn,135821,134047,1774,2019.csv,2019,98.69386913658418,1.3061308634158193
4895,I Will Follow,135809,135809,0,2011.csv,2011,100.0,0.0
4896,Mantra: Sounds Into Silence,135684,115013,20671,2018.csv,2018,84.765337106807,15.234662893193008
4897,Skin,135562,0,135562,2019.csv,2019,0.0,100.0
4898,Sonchiriya,135413,86765,48648,2019.csv,2019,64.07435032087022,35.925649679129776
4899,La Sapienza,135392,135392,0,2015.csv,2015,100.0,0.0
4900,The Kind Words,135382,135382,0,2016.csv,2016,100.0,0.0
4901,The Other Dream Team,135228,135228,0,2012.csv,2012,100.0,0.0
4902,The Other Story,135191,135191,0,2019.csv,2019,100.0,0.0
4903,The Bolshoi Ballet: Live From Moscow - A Hero of Our Time,135168,104837,30331,2017.csv,2017,77.56051728219697,22.43948271780303
4904,My Neighbor Totoro 2015 Re-release,134877,0,134877,2015.csv,2015,0.0,100.0
4905,Another Day of Life,134801,3190,131611,2018.csv,2018,2.366451287453357,97.63354871254664
4906,Led Zeppelin: Celebration Day,134753,0,134753,2012.csv,2012,0.0,100.0
4907,Attenberg,134503,24036,110467,2010.csv,2010,17.870233377694177,82.12976662230582
4908,The Times of Bill Cunningham,134288,134288,0,2020.csv,2020,100.0,0.0
4909,Ism,134165,134165,0,2016.csv,2016,100.0,0.0
4910,Redwood Highway,134049,134049,0,2014.csv,2014,100.0,0.0
4911,The Great Museum,133905,18020,115885,2014.csv,2014,13.457301818453383,86.54269818154661
4912,Pure Country 2: The Gift,133771,133771,0,2010.csv,2010,100.0,0.0
4913,Don't Think I've Forgotten: Cambodia's Lost Rock and Roll,133443,133443,0,2015.csv,2015,100.0,0.0
4914,Under the Shadow,133324,31900,101424,2016.csv,2016,23.926674867240706,76.0733251327593
4915,The Jewish Cardinal,133232,133232,0,2014.csv,2014,100.0,0.0
4916,"Hare Krishna! The Mantra, the Movement and the Swami Who Started It",133006,133006,0,2017.csv,2017,100.0,0.0
4917,Tonight You're Mine,132787,6255,126532,2011.csv,2011,4.710551484708594,95.28944851529141
4918,Dawson City: Frozen Time,132369,132369,0,2016.csv,2016,100.0,0.0
4919,Kumaré,132160,132160,0,2012.csv,2012,100.0,0.0
4920,My Brother the Devil,132056,44906,87150,2012.csv,2012,34.00527049130672,65.99472950869328
4921,How to Survive a Plague,132055,132055,0,2012.csv,2012,100.0,0.0
4922,A Ballerina's Tale,131995,131995,0,2015.csv,2015,100.0,0.0
4923,Mugamoodi,131965,101000,30965,2012.csv,2012,76.53544500435721,23.464554995642782
4924,28 Hotel Rooms,131208,18869,112339,2012.csv,2012,14.380982866898359,85.61901713310164
4925,Rudy 2018 Re-release,131200,131200,0,2018.csv,2018,100.0,0.0
4926,The Wind,130974,28252,102722,2019.csv,2019,21.570693420068103,78.42930657993189
4927,Mister America,130897,130897,0,2019.csv,2019,100.0,0.0
4928,The Image Book,130802,94153,36649,2018.csv,2018,71.98131527040871,28.018684729591293
4929,October,130335,32127,98208,2010.csv,2010,24.649556911036942,75.35044308896306
4930,Five Seasons: The Gardens of Piet Oudolf,130319,119223,11096,2018.csv,2018,91.48550863649967,8.514491363500335
4931,Requiem for the American Dream,130152,130152,0,2016.csv,2016,100.0,0.0
4932,Harry Potter and the Half-Blood Prince 2018 Re-release,130081,130081,0,2018.csv,2018,100.0,0.0
4933,Section 375,129916,0,129916,2019.csv,2019,0.0,100.0
4934,The Fairy,129818,38399,91419,2011.csv,2011,29.57910305196506,70.42089694803494
4935,Great Performances at the Met: Puccini: Madama Butterfly,129730,129730,0,2018.csv,2018,100.0,0.0
4936,Great Performances at the Met: Tchaikovsky: Eugene Onegin 2018 Re-release,129498,129498,0,2018.csv,2018,100.0,0.0
4937,Great Performances at the Met: Verdi: Il Trovatore,129393,129393,0,2018.csv,2018,100.0,0.0
4938,I Called Him Morgan,128986,128986,0,2017.csv,2017,100.0,0.0
4939,Yossi,128668,117047,11621,2012.csv,2012,90.96822830851494,9.031771691485062
4940,Love After Love,128602,121098,7504,2018.csv,2018,94.16494300244163,5.835056997558358
4941,The Adventurer: The Curse of the Midas Box,128471,6399,122072,2014.csv,2014,4.980890629013552,95.01910937098644
4942,Where Hands Touch,128269,67743,60526,2018.csv,2018,52.81322844958641,47.18677155041359
4943,Stonewall Uprising,128203,128203,0,2010.csv,2010,100.0,0.0
4944,Computer Chess,127852,102041,25811,2013.csv,2013,79.81181365954384,20.188186340456152
4945,Steve Jobs: The Lost Interview,127541,105710,21831,2011.csv,2011,82.88315130036615,17.116848699633845
4946,Benda Bilili!,127362,13420,113942,2010.csv,2010,10.536894835194172,89.46310516480584
4947,Sleepless in Seattle 2018 Re-release,127281,127281,0,2018.csv,2018,100.0,0.0
4948,A Band Called Death,127257,127257,0,2013.csv,2013,100.0,0.0
4949,Chimes at Midnight,126724,126724,0,2016.csv,2016,100.0,0.0
4950,Silent Night,126594,14567,112027,2012.csv,2012,11.5068644643506,88.4931355356494
4951,Escape Fire: The Fight to Rescue American Healthcare,126238,126238,0,2012.csv,2012,100.0,0.0
4952,The Arbor,126182,21620,104562,2010.csv,2010,17.133981074955223,82.86601892504478
4953,Lucky Grandma,126169,102000,24169,2020.csv,2020,80.84394740387893,19.156052596121075
4954,The Great Buster,125807,118344,7463,2018.csv,2018,94.06789765275381,5.932102347246179
4955,Europa Report,125687,125687,0,2013.csv,2013,100.0,0.0
4956,Paris Is Burning 2019 Re-release,125677,125677,0,2019.csv,2019,100.0,0.0
4957,Only,125603,0,125603,2020.csv,2020,0.0,100.0
4958,This Changes Everything,125348,64988,60360,2019.csv,2019,51.84606056738041,48.15393943261959
4959,Rosie,125319,6839,118480,2019.csv,2019,5.457273039203951,94.54272696079606
4960,The B-Side: Elsa Dorfman's Portrait Photography,125227,125227,0,2017.csv,2017,100.0,0.0
4961,Spinning Plates,124856,112449,12407,2013.csv,2013,90.06295252130454,9.937047478695456
4962,Mary Magdalene 2019 Re-release,124741,124741,0,2019.csv,2019,100.0,0.0
4963,Every Secret Thing,124733,103536,21197,2015.csv,2015,83.00610103180394,16.993898968196067
4964,Hymn: Sarah Brightman in Concert,124707,113274,11433,2018.csv,2018,90.8321104669345,9.167889533065505
4965,Ran 2010 Re-release,124673,124673,0,2010.csv,2010,100.0,0.0
4966,A Tuba to Cuba,124592,121772,2820,2019.csv,2019,97.73661230255554,2.263387697444459
4967,'85: The Greatest Team in Football History,124573,124573,0,2018.csv,2018,100.0,0.0
4968,Final: The Rapture,124561,124561,0,2013.csv,2013,100.0,0.0
4969,Vidal Sassoon: The Movie,124532,85974,38558,2011.csv,2011,69.03767706292359,30.962322937076415
4970,Post Tenebras Lux,124279,39185,85094,2012.csv,2012,31.529864257034575,68.47013574296543
4971,The Square,124244,124244,0,2013.csv,2013,100.0,0.0
4972,Marguerite & Julien,123918,0,123918,2015.csv,2015,0.0,100.0
4973,Knights of Badassdom,123854,123854,0,2014.csv,2014,100.0,0.0
4974,Wings of Desire 2018 Re-release,123830,123830,0,2018.csv,2018,100.0,0.0
4975,The Magic of Belle Isle,123821,102388,21433,2012.csv,2012,82.69033524200256,17.30966475799743
4976,Puncture,123700,68945,54755,2011.csv,2011,55.73565076798707,44.26434923201293
4977,Appropriate Behavior,123699,46912,76787,2015.csv,2015,37.92431628388265,62.07568371611735
4978,Sigur Rós: Inni,123482,123482,0,2011.csv,2011,100.0,0.0
4979,Downtown 81 2019 Re-release,123387,123387,0,2019.csv,2019,100.0,0.0
4980,Easy Rider 2019 Re-release,123276,123276,0,2019.csv,2019,100.0,0.0
4981,The Last Mountain,122961,122961,0,2011.csv,2011,100.0,0.0
4982,Ashby,122919,4631,118288,2015.csv,2015,3.7675217012829587,96.23247829871704
4983,Blood Fest,122833,82774,40059,2018.csv,2018,67.38742845977872,32.612571540221275
4984,"14 Days, 12 Nights",122806,122530,276,2020.csv,2020,99.77525528068661,0.2247447193133886
4985,Do I Sound Gay?,122595,119388,3207,2015.csv,2015,97.38406949712468,2.615930502875321
4986,Tragedy Girls,122211,61899,60312,2017.csv,2017,50.649286889068904,49.350713110931096
4987,The Ones Below,121827,12488,109339,2016.csv,2016,10.250601262445928,89.74939873755407
4988,Tremors,121813,23911,97902,2019.csv,2019,19.629267812138277,80.37073218786173
4989,Yu-Gi-Oh!: The Movie - Pyramid of Light 2018 Re-release,121688,121688,0,2018.csv,2018,100.0,0.0
4990,Letters to Elena,121254,8511,112743,2012.csv,2012,7.019149883715177,92.98085011628481
4991,Afflicted,121179,121179,0,2014.csv,2014,100.0,0.0
4992,In Jackson Heights,121094,121094,0,2015.csv,2015,100.0,0.0
4993,Michael,121034,15715,105319,2011.csv,2011,12.983954921757523,87.01604507824247
4994,The Girl Without Hands,121020,21787,99233,2016.csv,2016,18.00280945298298,81.99719054701701
4995,Miss Sharon Jones!,120880,120880,0,2016.csv,2016,100.0,0.0
4996,Better Living Through Chemistry,120823,75143,45680,2014.csv,2014,62.192628886884116,37.80737111311588
4997,Hockney 2016 Re-release,120745,120745,0,2016.csv,2016,100.0,0.0
4998,Cowgirls 'n Angels,120680,120680,0,2012.csv,2012,100.0,0.0
4999,Spark: A Burning Man Story,120459,120459,0,2013.csv,2013,100.0,0.0
5000,Foodfight!,120141,0,120141,2012.csv,2012,0.0,100.0
5001,Blank City,119929,116037,3892,2011.csv,2011,96.75474655838038,3.245253441619625
5002,Avant qu'on explose,119894,119894,0,2019.csv,2019,100.0,0.0
5003,The Pearl Button,119753,42166,77587,2015.csv,2015,35.21080891501674,64.78919108498326
5004,Digging for Fire,119364,119364,0,2015.csv,2015,100.0,0.0
5005,Valley of the Heart's Delight,119290,119290,0,2010.csv,2010,100.0,0.0
5006,Celine: Through the Eyes of the World,119274,0,119274,2010.csv,2010,0.0,100.0
5007,Remember the Goal,119100,119100,0,2016.csv,2016,100.0,0.0
5008,Until Forever 2016 Re-release,118795,105358,13437,2016.csv,2016,88.68891788374931,11.311082116250684
5009,Neither Heaven Nor Earth,118663,12810,105853,2015.csv,2015,10.795277382166303,89.2047226178337
5010,The Levelling,118451,3040,115411,2017.csv,2017,2.5664620813669785,97.43353791863302
5011,See What I'm Saying: The Deaf Entertainers Documentary,118206,118206,0,2010.csv,2010,100.0,0.0
5012,Styx,118188,70794,47394,2018.csv,2018,59.899482180932075,40.100517819067925
5013,Come to Daddy,117947,96713,21234,2020.csv,2020,81.99699865193689,18.003001348063112
5014,Victor,117755,117755,0,2016.csv,2016,100.0,0.0
5015,The Decoy Bride,117754,759,116995,2011.csv,2011,0.644564091241062,99.35543590875893
5016,Freakonomics,117678,101270,16408,2010.csv,2010,86.05686704396743,13.943132956032564
5017,Bisbee '17,117470,117470,0,2018.csv,2018,100.0,0.0
5018,George Takei's Allegiance 2018 Re-release,117162,117162,0,2018.csv,2018,100.0,0.0
5019,Jauja 2014 Re-release,117117,60231,56886,2014.csv,2014,51.42805912036681,48.57194087963318
5020,Gimme the Loot,116783,104442,12341,2013.csv,2013,89.43253726997936,10.567462730020637
5021,A Case of You,116559,4187,112372,2013.csv,2013,3.5921722046345623,96.40782779536544
5022,The Undefeated,116381,116381,0,2011.csv,2011,100.0,0.0
5023,Touching Home,116353,116353,0,2010.csv,2010,100.0,0.0
5024,The Art of Flight,116134,0,116134,2012.csv,2012,0.0,100.0
5025,Mob Psycho 100,115766,115766,0,2019.csv,2019,100.0,0.0
5026,I Am Divine,115739,81497,34242,2013.csv,2013,70.41446703358419,29.58553296641582
5027,Headshot,115511,1373,114138,2011.csv,2011,1.1886313857554691,98.81136861424453
5028,Caged No More,114959,114959,0,2016.csv,2016,100.0,0.0
5029,Nostalgia,114603,114603,0,2018.csv,2018,100.0,0.0
5030,Sympathy for the Devil,114301,51150,63151,2019.csv,2019,44.750264652102786,55.24973534789722
5031,John McEnroe: In the Realm of Perfection,114289,90964,23325,2018.csv,2018,79.5912117526621,20.40878824733789
5032,Ain't in It for My Health: A Film About Levon Helm,113966,113966,0,2013.csv,2013,100.0,0.0
5033,Bodied,113956,113956,0,2018.csv,2018,100.0,0.0
5034,The Woman Who Loves Giraffes,113858,113858,0,2019.csv,2019,100.0,0.0
5035,35 and Ticking,113794,113794,0,2011.csv,2011,100.0,0.0
5036,The Goonies 2015 Re-release,113538,113538,0,2015.csv,2015,100.0,0.0
5037,"We Love You, Sally Carmichael!",113435,113435,0,2017.csv,2017,100.0,0.0
5038,Abacus: Small Enough to Jail,113278,113278,0,2017.csv,2017,100.0,0.0
5039,God the Father,113276,113276,0,2014.csv,2014,100.0,0.0
5040,Burn 2012 Re-release,113173,113173,0,2012.csv,2012,100.0,0.0
5041,Road Hard,113169,113169,0,2015.csv,2015,100.0,0.0
5042,Police Story,113164,113164,0,2019.csv,2019,100.0,0.0
5043,Filmworker,112828,102609,10219,2018.csv,2018,90.94285106533839,9.057148934661608
5044,Follow Me: The Yoni Netanyahu Story,112679,112679,0,2012.csv,2012,100.0,0.0
5045,A Boy. A Girl. A Dream.,112552,112552,0,2018.csv,2018,100.0,0.0
5046,The Recall,112357,22943,89414,2017.csv,2017,20.419733527951085,79.5802664720489
5047,"Hale County This Morning, This Evening",112282,112282,0,2018.csv,2018,100.0,0.0
5048,The Dawn Wall,112191,112191,0,2018.csv,2018,100.0,0.0
5049,Penton: The John Penton Story,112159,112159,0,2014.csv,2014,100.0,0.0
5050,How Viktor 'The Garlic' Took Alexey 'The Stud' to the Nursing Home,112071,12954,99117,2017.csv,2017,11.558744010493347,88.44125598950666
5051,Marwencol,112036,112036,0,2010.csv,2010,100.0,0.0
5052,A Chance in the World,112007,112007,0,2018.csv,2018,100.0,0.0
5053,Una noche,111903,100887,11016,2013.csv,2013,90.15575989919842,9.844240100801587
5054,Saint John of Las Vegas,111731,102645,9086,2010.csv,2010,91.86796860316295,8.132031396837046
5055,1915,111682,111682,0,2015.csv,2015,100.0,0.0
5056,Rich Hill,111376,111376,0,2014.csv,2014,100.0,0.0
5057,Elevator to the Gallows 2016 Re-release,111267,111267,0,2016.csv,2016,100.0,0.0
5058,Heaven,111232,111232,0,2020.csv,2020,100.0,0.0
5059,"Wild Horse, Wild Ride",111205,111205,0,2012.csv,2012,100.0,0.0
5060,A Paris Education,111197,21598,89599,2018.csv,2018,19.423185877316833,80.57681412268317
5061,Strangerland,111107,17472,93635,2015.csv,2015,15.725381839128048,84.27461816087195
5062,The Obama Effect,110904,110904,0,2012.csv,2012,100.0,0.0
5063,The Overnighters,110763,110763,0,2014.csv,2014,100.0,0.0
5064,Duran Duran: Unstaged,110746,110746,0,2014.csv,2014,100.0,0.0
5065,The Perfect Family,110313,110313,0,2012.csv,2012,100.0,0.0
5066,The Trouble with Terkel,110289,110289,0,2017.csv,2017,100.0,0.0
5067,Roar,110048,110048,0,2015.csv,2015,100.0,0.0
5068,Best Worst Movie,109895,109895,0,2010.csv,2010,100.0,0.0
5069,The Fifth Element 2017 Re-release,109786,0,109786,2017.csv,2017,0.0,100.0
5070,Babylon,109749,109749,0,2019.csv,2019,100.0,0.0
5071,Zero Days,109649,109649,0,2016.csv,2016,100.0,0.0
5072,Anohana the Movie: The Flower We Saw That Day (Ano hi mita hana no namae wo bokutachi wa mada shiran,109630,109630,0,2014.csv,2014,100.0,0.0
5073,Cameraperson,109464,102033,7431,2016.csv,2016,93.21146678360009,6.788533216399912
5074,Wedding Party 2,109459,11140,98319,2017.csv,2017,10.177326670260097,89.8226733297399
5075,Blood Done Sign My Name,109383,109383,0,2010.csv,2010,100.0,0.0
5076,The Lure,108846,101657,7189,2017.csv,2017,93.39525568234018,6.604744317659813
5077,Adult Beginners,108808,108808,0,2015.csv,2015,100.0,0.0
5078,Sworn Virgin,108681,4636,104045,2015.csv,2015,4.265695015688115,95.73430498431188
5079,Red Sorghum,108371,0,108371,2018.csv,2018,0.0,100.0
5080,Violet & Daisy,108139,17186,90953,2013.csv,2013,15.892508715634508,84.1074912843655
5081,Bettie Page Reveals All,108118,108118,0,2013.csv,2013,100.0,0.0
5082,"Love, Cecil",107940,106057,1883,2017.csv,2017,98.25551232166018,1.7444876783398184
5083,Kidnapping of Michel Houellebecq,107641,11546,96095,2014.csv,2014,10.726396075844706,89.2736039241553
5084,Revenge of the Green Dragons,107412,0,107412,2014.csv,2014,0.0,100.0
5085,"No Date, No Signature",107368,36444,70924,2018.csv,2018,33.943074286565825,66.05692571343417
5086,Cockneys vs Zombies,107348,0,107348,2012.csv,2012,0.0,100.0
5087,National Theatre Live: Julius Caesar,107057,107057,0,2018.csv,2018,100.0,0.0
5088,Jeruzalem,107024,11287,95737,2016.csv,2016,10.546232620720586,89.45376737927941
5089,Best Worst Thing That Ever Could Have Happened,106986,106986,0,2016.csv,2016,100.0,0.0
5090,The Tales of Hoffmann,106860,91930,14930,2015.csv,2015,86.02844843720756,13.971551562792438
5091,Ivory Tower,106771,106771,0,2014.csv,2014,100.0,0.0
5092,Vita Activa: The Spirit of Hannah Arendt,106768,82143,24625,2016.csv,2016,76.93597332534092,23.064026674659075
5093,Dekalog 2016 Re-release,106494,106494,0,2016.csv,2016,100.0,0.0
5094,Wrong,106425,46021,60404,2012.csv,2012,43.24265914963589,56.7573408503641
5095,The Charmer,106379,26167,80212,2018.csv,2018,24.59789996145856,75.40210003854145
5096,Six Dance Lessons in Six Weeks,106323,106323,0,2014.csv,2014,100.0,0.0
5097,The Bachelors,106212,0,106212,2017.csv,2017,0.0,100.0
5098,The Brink,106057,106057,0,2019.csv,2019,100.0,0.0
5099,Big Star: Nothing Can Hurt Me,105998,105998,0,2013.csv,2013,100.0,0.0
5100,Miss Juneteenth,105908,92349,13559,2020.csv,2020,87.19737885712128,12.802621142878726
5101,The Roads Not Taken,105439,3518,101921,2020.csv,2020,3.3365263327611223,96.66347366723888
5102,Never Heard,105271,105271,0,2018.csv,2018,100.0,0.0
5103,Cold Case Hammarskjöld,104965,104965,0,2019.csv,2019,100.0,0.0
5104,Always and Forever,104871,0,104871,2019.csv,2019,0.0,100.0
5105,A Ciambra,104808,41934,62874,2017.csv,2017,40.01030455690405,59.98969544309595
5106,Dictator,104734,104734,0,2016.csv,2016,100.0,0.0
5107,Band Baaja Baaraat,104532,43820,60712,2010.csv,2010,41.92017755328512,58.07982244671488
5108,Results,104507,104507,0,2015.csv,2015,100.0,0.0
5109,Demon,104038,104038,0,2016.csv,2016,100.0,0.0
5110,The Investigator,103739,103739,0,2013.csv,2013,100.0,0.0
5111,Stevie Nicks: In Your Dreams,103028,103028,0,2013.csv,2013,100.0,0.0
5112,Puerto Ricans in Paris,102890,102890,0,2016.csv,2016,100.0,0.0
5113,Brake,102819,4876,97943,2012.csv,2012,4.742314163724604,95.2576858362754
5114,The Gracefield Incident,102256,0,102256,2017.csv,2017,0.0,100.0
5115,Tanna,102225,46654,55571,2016.csv,2016,45.6385424309122,54.361457569087804
5116,Andrei Rublev 2018 Re-release,102021,102021,0,2018.csv,2018,100.0,0.0
5117,Becoming Traviata,102015,62652,39363,2013.csv,2013,61.41449786796059,38.58550213203941
5118,Tower,101987,101987,0,2016.csv,2016,100.0,0.0
5119,In the Family,101934,101934,0,2011.csv,2011,100.0,0.0
5120,Hotel by the River,101879,28354,73525,2019.csv,2019,27.83105448620422,72.16894551379578
5121,Kill Me Three Times,101807,24296,77511,2015.csv,2015,23.864763719587064,76.13523628041294
5122,Magnus,101739,8944,92795,2016.csv,2016,8.791122381780832,91.20887761821916
5123,Those Who Remained,101737,0,101737,2019.csv,2019,0.0,100.0
5124,Rubber,101729,100370,1359,2011.csv,2011,98.66409774990416,1.3359022500958428
5125,Kickboxer: Retaliation,101690,4537,97153,2018.csv,2018,4.461598977283902,95.5384010227161
5126,A Lego Brickumentary,101531,101531,0,2015.csv,2015,100.0,0.0
5127,Blazing Saddles 2013 Re-release,101481,101481,0,2013.csv,2013,100.0,0.0
5128,Man from Reno,101438,101438,0,2015.csv,2015,100.0,0.0
5129,James White,101368,101368,0,2015.csv,2015,100.0,0.0
5130,QT8: The First Eight,101346,51896,49450,2019.csv,2019,51.20675705010558,48.79324294989442
5131,Korengal,101310,101310,0,2014.csv,2014,100.0,0.0
5132,Feed the Fish,101170,101170,0,2010.csv,2010,100.0,0.0
5133,Beyond Sight: The Derek Rabelo Story,101074,101074,0,2014.csv,2014,100.0,0.0
5134,First Cow,101068,101068,0,2020.csv,2020,100.0,0.0
5135,The Good Guy,100688,100688,0,2010.csv,2010,100.0,0.0
5136,The Man Who Fell to Earth,100468,100072,396,2011.csv,2011,99.6058446470518,0.39415535294820236
5137,The United States of Autism,100403,100403,0,2013.csv,2013,100.0,0.0
5138,One Track Heart: The Story of Krishna Das,100401,100401,0,2013.csv,2013,100.0,0.0
5139,All About Nina,100335,100335,0,2018.csv,2018,100.0,0.0
5140,8: The Mormon Proposition,100280,100280,0,2010.csv,2010,100.0,0.0
5141,Rejoice and Shout,100237,100237,0,2011.csv,2011,100.0,0.0
5142,Bhutto,100202,100202,0,2010.csv,2010,100.0,0.0
5143,White Lion,99635,0,99635,2010.csv,2010,0.0,100.0
5144,Papi Chulo,99546,84703,14843,2019.csv,2019,85.08930544672815,14.910694553271856
5145,Heavy Water,99503,55446,44057,2019.csv,2019,55.72294302684341,44.27705697315659
5146,Meow Wolf: Origin Story,99488,99488,0,2018.csv,2018,100.0,0.0
5147,Kings of the Evening,99270,99270,0,2010.csv,2010,100.0,0.0
5148,Cemetery of Splendor,98932,51950,46982,2015.csv,2015,52.51081550964298,47.48918449035701
5149,High Strung Free Dance 2019 Re-release,98481,83891,14590,2019.csv,2019,85.18495953534185,14.815040464658157
5150,Aida's Secrets,98468,98468,0,2017.csv,2017,100.0,0.0
5151,Reign of Judges: Title of Liberty - Concept Short,98408,93224,5184,2018.csv,2018,94.73213559873182,5.26786440126819
5152,Blind,98280,12522,85758,2017.csv,2017,12.74114774114774,87.25885225885226
5153,Charlie Says,98240,40685,57555,2019.csv,2019,41.413884364820845,58.58611563517915
5154,National Theatre Live: Macbeth,97857,97857,0,2018.csv,2018,100.0,0.0
5155,Tim Timmerman: Hope of America,97727,97727,0,2017.csv,2017,100.0,0.0
5156,The Here After,97699,0,97699,2015.csv,2015,0.0,100.0
5157,In Bloom,97236,56092,41144,2013.csv,2013,57.68645357686454,42.31354642313546
5158,Difret,97205,49667,47538,2015.csv,2015,51.09510827632323,48.90489172367676
5159,Prassthanam,97204,19984,77220,2019.csv,2019,20.558824739722645,79.44117526027735
5160,A Field in England,97195,32846,64349,2013.csv,2013,33.79391944030043,66.20608055969957
5161,Little Monsters,97111,0,97111,2019.csv,2019,0.0,100.0
5162,Kisses 2010 Re-release,96933,81680,15253,2010.csv,2010,84.26438880463826,15.735611195361745
5163,A Little Help,96868,96868,0,2011.csv,2011,100.0,0.0
5164,Leviathan,96778,76202,20576,2013.csv,2013,78.73896960052905,21.261030399470954
5165,Singin' in the Rain 2013 Re-release,96763,96763,0,2013.csv,2013,100.0,0.0
5166,Hardflip,96734,96734,0,2012.csv,2012,100.0,0.0
5167,Sunshine Superman,96715,88097,8618,2015.csv,2015,91.08928294473453,8.910717055265472
5168,Godspeed: The Race Across America,96690,96690,0,2018.csv,2018,100.0,0.0
5169,A Poem Is a Naked Person,96592,96592,0,2015.csv,2015,100.0,0.0
5170,Dina,96524,90503,6021,2017.csv,2017,93.76217313828685,6.237826861713149
5171,Hiroshima Mon Amour 2014 Re-release,96439,96439,0,2014.csv,2014,100.0,0.0
5172,My Reincarnation,96115,92822,3293,2011.csv,2011,96.57389585392498,3.4261041460750143
5173,A Bigger Splash 2019 Re-release,95826,95826,0,2019.csv,2019,100.0,0.0
5174,Saand Ki Aankh,95724,0,95724,2019.csv,2019,0.0,100.0
5175,Ardor,95549,18565,76984,2014.csv,2014,19.429821348208772,80.57017865179122
5176,The Lovers & the Despot,95521,55511,40010,2016.csv,2016,58.11392259293768,41.886077407062324
5177,The Final Wish,95215,25183,70032,2019.csv,2019,26.448563776715854,73.55143622328416
5178,The Night Eats the World,95208,0,95208,2018.csv,2018,0.0,100.0
5179,Queen of Earth,95183,91218,3965,2015.csv,2015,95.8343401657859,4.165659834214093
5180,Saala Khadoos,94787,76931,17856,2016.csv,2016,81.16197368837499,18.83802631162501
5181,The Fight Within,94326,94326,0,2016.csv,2016,100.0,0.0
5182,Keep Watching,94178,94178,0,2017.csv,2017,100.0,0.0
5183,Blue Caprice,93995,93995,0,2013.csv,2013,100.0,0.0
5184,Let the Corpses Tan,93409,93409,0,2018.csv,2018,100.0,0.0
5185,First Lady,93298,93298,0,2020.csv,2020,100.0,0.0
5186,Will You Still Love Me Tomorrow?,93046,6694,86352,2013.csv,2013,7.194290995851514,92.80570900414848
5187,Vamps,92748,3361,89387,2012.csv,2012,3.623797817742701,96.3762021822573
5188,The First Time,92654,22836,69818,2012.csv,2012,24.646534418373733,75.35346558162627
5189,American: The Bill Hicks Story,92234,92234,0,2011.csv,2011,100.0,0.0
5190,Into the Forest,92166,9995,82171,2016.csv,2016,10.844563070980621,89.15543692901939
5191,Nancy,92000,80115,11885,2018.csv,2018,87.08152173913042,12.918478260869565
5192,Generation War,91595,91595,0,2014.csv,2014,100.0,0.0
5193,Legends from the Sky,91462,91462,0,2015.csv,2015,100.0,0.0
5194,Other People,91441,91441,0,2016.csv,2016,100.0,0.0
5195,Evil Bong 3: The Wrath of Bong,91260,91260,0,2011.csv,2011,100.0,0.0
5196,Morris from America,91151,91151,0,2016.csv,2016,100.0,0.0
5197,A Kind of Murder,91149,2915,88234,2016.csv,2016,3.198060318818638,96.80193968118135
5198,Mapplethorpe,91002,91002,0,2019.csv,2019,100.0,0.0
5199,BANDSTAND: The Broadway Musical on Screen 2018 Re-release,91000,91000,0,2018.csv,2018,100.0,0.0
5200,Because of Grácia,90878,90878,0,2017.csv,2017,100.0,0.0
5201,Porto,90849,15126,75723,2017.csv,2017,16.649605389162236,83.35039461083777
5202,Heroic Antics,90785,63649,27136,2014.csv,2014,70.10959960345872,29.890400396541278
5203,Beasts of No Nation,90777,90777,0,2015.csv,2015,100.0,0.0
5204,Yuri!!! On Ice,90751,81878,8873,2018.csv,2018,90.2226972705535,9.777302729446507
5205,Loopers: The Caddie's Long Walk,90679,90679,0,2019.csv,2019,100.0,0.0
5206,Moonwalkers,90646,0,90646,2016.csv,2016,0.0,100.0
5207,The Good Neighbor,90573,0,90573,2016.csv,2016,0.0,100.0
5208,Fireworks Wednesday 2016 Re-release,90519,90519,0,2016.csv,2016,100.0,0.0
5209,Minding the Gap,90328,11998,78330,2018.csv,2018,13.28270303781773,86.71729696218226
5210,Dark Horse,90136,90136,0,2015.csv,2015,100.0,0.0
5211,King's Faith,90106,90106,0,2013.csv,2013,100.0,0.0
5212,Running for Grace,89988,89988,0,2018.csv,2018,100.0,0.0
5213,Pump,89787,89787,0,2014.csv,2014,100.0,0.0
5214,The Principle,89543,89543,0,2014.csv,2014,100.0,0.0
5215,Max Winslow and the House of Secrets,89532,31250,58282,2020.csv,2020,34.903721574409154,65.09627842559085
5216,Oy Vey! My Son Is Gay!!,89507,89507,0,2010.csv,2010,100.0,0.0
5217,Somebody Up There Likes Me,89435,89435,0,2013.csv,2013,100.0,0.0
5218,Cat on a Hot Tin Roof,89332,89332,0,2018.csv,2018,100.0,0.0
5219,Salvation Boulevard,89182,28468,60714,2011.csv,2011,31.921239712049516,68.07876028795047
5220,Night of the Living Dead,89029,89029,0,2017.csv,2017,100.0,0.0
5221,This Is Not a Film,88758,77016,11742,2012.csv,2012,86.77076995876428,13.22923004123572
5222,The Lumber Baron,88336,88336,0,2019.csv,2019,100.0,0.0
5223,Crazy on the Outside,88335,88335,0,2010.csv,2010,100.0,0.0
5224,Jewtopia,88327,46437,41890,2013.csv,2013,52.57395813284727,47.42604186715274
5225,Money for Nothing: Inside the Federal Reserve,88045,88045,0,2013.csv,2013,100.0,0.0
5226,Jim Allison: Breakthrough,87984,87984,0,2019.csv,2019,100.0,0.0
5227,Hyena Road,87768,1430,86338,2015.csv,2015,1.6292954151854893,98.3707045848145
5228,The Cartel,87763,87763,0,2010.csv,2010,100.0,0.0
5229,Ocean Waves,87738,87738,0,2016.csv,2016,100.0,0.0
5230,Glory,87728,18415,69313,2017.csv,2017,20.991017691045048,79.00898230895496
5231,Exporting Raymond,87727,87727,0,2011.csv,2011,100.0,0.0
5232,Author: The JT LeRoy Story,87686,85999,1687,2016.csv,2016,98.07608968364391,1.9239103163560887
5233,Goldstone 2018 Re-release,87639,87639,0,2018.csv,2018,100.0,0.0
5234,Ammonite,87552,87552,0,2020.csv,2020,100.0,0.0
5235,ECCO,86858,86858,0,2019.csv,2019,100.0,0.0
5236,Singularity,86822,4176,82646,2017.csv,2017,4.809840823754348,95.19015917624564
5237,Vault,86741,29491,57250,2019.csv,2019,33.99891631408446,66.00108368591555
5238,Gueros,86736,60114,26622,2015.csv,2015,69.30686220254566,30.693137797454344
5239,School Life,86616,37381,49235,2017.csv,2017,43.15715341276439,56.84284658723562
5240,Beuys,86451,65410,21041,2018.csv,2018,75.66135730066743,24.338642699332567
5241,"My Love, Don't Cross That River 2016 Re-release",86446,86446,0,2016.csv,2016,100.0,0.0
5242,National Theater Live: Cyrano de Bergerac,86300,86300,0,2019.csv,2019,100.0,0.0
5243,Crazy Wisdom: The Life & Times of Chogyam Trungpa Rinpoche,86202,86202,0,2011.csv,2011,100.0,0.0
5244,Rapt 2011 Re-release,86028,45759,40269,2011.csv,2011,53.190821592969726,46.809178407030274
5245,Mudbound,85955,0,85955,2017.csv,2017,0.0,100.0
5246,Tab Hunter Confidential,85812,85812,0,2015.csv,2015,100.0,0.0
5247,Jackals,85410,0,85410,2017.csv,2017,0.0,100.0
5248,Skid Row Marathon,84997,84997,0,2019.csv,2019,100.0,0.0
5249,Waking Sleeping Beauty,84918,80741,4177,2010.csv,2010,95.08113709696413,4.91886290303587
5250,Ran 2016 Re-release,84789,66097,18692,2016.csv,2016,77.9546875184281,22.0453124815719
5251,Wretches & Jabberers,84610,84610,0,2011.csv,2011,100.0,0.0
5252,Visitors,84577,84577,0,2014.csv,2014,100.0,0.0
5253,Woodstock,84440,84440,0,2019.csv,2019,100.0,0.0
5254,Heaven Knows What,84417,80734,3683,2015.csv,2015,95.63713470035657,4.3628652996434365
5255,The Diabolical,84259,0,84259,2015.csv,2015,0.0,100.0
5256,Chapter & Verse,84147,84147,0,2017.csv,2017,100.0,0.0
5257,Los Sures,83992,83992,0,2016.csv,2016,100.0,0.0
5258,The Disappearance of My Mother,83930,24951,58979,2019.csv,2019,29.728345049445963,70.27165495055402
5259,"Nico, 1988",83558,73304,10254,2018.csv,2018,87.72828454486704,12.271715455132961
5260,The Look,83137,19988,63149,2011.csv,2011,24.04224352574666,75.95775647425334
5261,The Kindness of Strangers,83042,2705,80337,2019.csv,2019,3.2573878278461503,96.74261217215385
5262,Hateship Loveship,83008,54030,28978,2014.csv,2014,65.09011179645336,34.90988820354664
5263,Alien Abduction,82725,12897,69828,2014.csv,2014,15.590208522212148,84.40979147778785
5264,Doctor Who: The Woman Who Fell to Earth,82698,82698,0,2018.csv,2018,100.0,0.0
5265,12 O'Clock Boys,82614,82614,0,2014.csv,2014,100.0,0.0
5266,V/H/S Viral,82409,2756,79653,2014.csv,2014,3.3442949192442577,96.65570508075574
5267,The Treasure,82392,50203,32189,2016.csv,2016,60.931886590931164,39.06811340906884
5268,Water & Power,82312,82312,0,2014.csv,2014,100.0,0.0
5269,Prey,82258,0,82258,2019.csv,2019,0.0,100.0
5270,Careful What You Wish For,82230,0,82230,2015.csv,2015,0.0,100.0
5271,On the Basis of Sex 2020 Re-release,82150,82150,0,2020.csv,2020,100.0,0.0
5272,The Whale,81881,81881,0,2011.csv,2011,100.0,0.0
5273,King Cobra,81757,81757,0,2016.csv,2016,100.0,0.0
5274,Inkubus,81600,81600,0,2011.csv,2011,100.0,0.0
5275,Hating Breitbart,81432,81432,0,2012.csv,2012,100.0,0.0
5276,The Girl in the Book,81379,8245,73134,2015.csv,2015,10.131606434092333,89.86839356590767
5277,Yomeddine,81030,11308,69722,2018.csv,2018,13.9553251882019,86.04467481179809
5278,The Island President,80996,76398,4598,2012.csv,2012,94.32317645315817,5.67682354684182
5279,Burning Bush,80943,16731,64212,2013.csv,2013,20.67010118231348,79.32989881768651
5280,Woman Walks Ahead,80912,57528,23384,2018.csv,2018,71.09946608661262,28.900533913387385
5281,Taur Mittran Di,80879,69510,11369,2012.csv,2012,85.94319909988995,14.056800900110042
5282,Kind Hearts and Coronets 2019 Re-release,80795,35948,44847,2019.csv,2019,44.492852280462905,55.507147719537095
5283,Nasty Baby,80772,79800,972,2015.csv,2015,98.796612687565,1.2033873124350023
5284,Trace Amounts,80735,80735,0,2015.csv,2015,100.0,0.0
5285,Batman Returns 2019 Re-release,80699,70642,10057,2019.csv,2019,87.5376398716217,12.462360128378295
5286,Ms. Purple,80657,80657,0,2019.csv,2019,100.0,0.0
5287,Enemies of the People,80654,73171,7483,2010.csv,2010,90.72209685818434,9.277903141815658
5288,Winnie Mandela,80634,80634,0,2013.csv,2013,100.0,0.0
5289,Armstrong,80169,19740,60429,2019.csv,2019,24.6229839464132,75.3770160535868
5290,For the Love of Spock,80141,80141,0,2016.csv,2016,100.0,0.0
5291,Inhale,80112,4115,75997,2010.csv,2010,5.136558817655282,94.86344118234472
5292,Ramaiya Vastavaiya,80108,80108,0,2013.csv,2013,100.0,0.0
5293,En el séptimo día,79887,79887,0,2018.csv,2018,100.0,0.0
5294,Aurangzeb,79665,0,79665,2013.csv,2013,0.0,100.0
5295,Harvest of Empire,79627,79627,0,2012.csv,2012,100.0,0.0
5296,Camp X-Ray,79624,13302,66322,2014.csv,2014,16.706018285943934,83.29398171405606
5297,End of the Century,79607,66309,13298,2019.csv,2019,83.29543884331781,16.704561156682203
5298,Jayne Mansfield's Car,79178,14836,64342,2013.csv,2013,18.737528101240244,81.26247189875976
5299,Concussion,78957,42606,36351,2013.csv,2013,53.96101675595577,46.03898324404423
5300,Fort McCoy,78948,78948,0,2014.csv,2014,100.0,0.0
5301,Christ Stopped at Eboli,78736,78736,0,2019.csv,2019,100.0,0.0
5302,The Boxcar Children - Surprise Island,78676,78676,0,2018.csv,2018,100.0,0.0
5303,Blackbird,78400,78400,0,2015.csv,2015,100.0,0.0
5304,Harold and Lillian: A Hollywood Love Story,78301,78301,0,2017.csv,2017,100.0,0.0
5305,Colliding Dreams,78288,78288,0,2016.csv,2016,100.0,0.0
5306,Anesthesia,78270,32163,46107,2016.csv,2016,41.092372556535075,58.907627443464925
5307,Nomad: In the Footsteps of Bruce Chatwin,78100,0,78100,2020.csv,2020,0.0,100.0
5308,Un traductor,78075,13509,64566,2018.csv,2018,17.302593659942364,82.69740634005764
5309,Jodi Breakers,78024,52618,25406,2012.csv,2012,67.43822413616323,32.561775863836765
5310,Table No. 21,77621,46720,30901,2013.csv,2013,60.18989706393888,39.810102936061114
5311,Chevalier,77590,25696,51894,2015.csv,2015,33.117669802809644,66.88233019719037
5312,Circo,77466,77466,0,2011.csv,2011,100.0,0.0
5313,The Art of the Steal,77450,64065,13385,2014.csv,2014,82.71788250484184,17.282117495158168
5314,Breaking Upwards,77389,77389,0,2010.csv,2010,100.0,0.0
5315,To Catch a Dollar: Muhammad Yunus Banks on America,77142,77142,0,2011.csv,2011,100.0,0.0
5316,Parchi,77110,69431,7679,2018.csv,2018,90.04149915704838,9.958500842951628
5317,The Missing Picture,76933,52164,24769,2014.csv,2014,67.8044532255339,32.195546774466095
5318,Fast Color,76916,76916,0,2019.csv,2019,100.0,0.0
5319,Mademoiselle C,76621,48668,27953,2013.csv,2013,63.51783453622375,36.48216546377625
5320,The New Rijksmuseum - The Film,76460,40578,35882,2015.csv,2015,53.07088673816375,46.92911326183625
5321,Night Catches Us,76185,76185,0,2010.csv,2010,100.0,0.0
5322,Don't Blink,76134,76134,0,2016.csv,2016,100.0,0.0
5323,93Queen,76056,76056,0,2018.csv,2018,100.0,0.0
5324,Greener Grass,76045,51456,24589,2019.csv,2019,67.66519823788546,32.33480176211454
5325,Whitey: United States of America v. James J. Bulger,75881,75881,0,2014.csv,2014,100.0,0.0
5326,Wish You Were Here 2013 Re-release,75870,46347,29523,2013.csv,2013,61.08738631870304,38.91261368129695
5327,Into the White 2013 Re-release,75747,704,75043,2013.csv,2013,0.9294097456004858,99.07059025439952
5328,Touch Me Not,75507,13782,61725,2018.csv,2018,18.252612340577695,81.74738765942232
5329,The Riot Act,75506,75506,0,2018.csv,2018,100.0,0.0
5330,Swim Little Fish Swim,75504,3877,71627,2014.csv,2014,5.134827293918203,94.86517270608181
5331,Bill Nye: Science Guy,74909,74909,0,2017.csv,2017,100.0,0.0
5332,Where Is Kyra?,74821,59717,15104,2018.csv,2018,79.81315406102564,20.18684593897435
5333,The Ornithologist,74714,50511,24203,2016.csv,2016,67.60580346387557,32.39419653612442
5334,Above and Beyond: NASA's Journey to Tomorrow,74711,74711,0,2018.csv,2018,100.0,0.0
5335,Batkid Begins: The Wish Heard Around the World,74709,74709,0,2015.csv,2015,100.0,0.0
5336,The Monster,74700,12544,62156,2016.csv,2016,16.792503346720213,83.20749665327979
5337,We Come as Friends,74633,50921,23712,2014.csv,2014,68.22853161470127,31.77146838529873
5338,Hadewijch,74586,5006,69580,2010.csv,2010,6.71171533531762,93.28828466468238
5339,Stations of the Cross,74509,1505,73004,2014.csv,2014,2.019890214604947,97.98010978539506
5340,Made in Bangladesh,74432,5322,69110,2019.csv,2019,7.150150472914875,92.84984952708513
5341,Reset,74341,5454,68887,2016.csv,2016,7.336463055379938,92.66353694462006
5342,The Boy Downstairs,73988,13638,60350,2018.csv,2018,18.43271881926799,81.56728118073201
5343,The Keeping Room,73922,27166,46756,2015.csv,2015,36.74954681962068,63.25045318037932
5344,After Auschwitz,73885,73885,0,2018.csv,2018,100.0,0.0
5345,War Pigs,73701,0,73701,2015.csv,2015,0.0,100.0
5346,Wait for Your Laugh,73585,73585,0,2017.csv,2017,100.0,0.0
5347,Prodigal Sons,73544,73544,0,2010.csv,2010,100.0,0.0
5348,On the Ice,73492,73492,0,2012.csv,2012,100.0,0.0
5349,Primal Rage: The Legend of Konga,73383,21497,51886,2018.csv,2018,29.29425071201777,70.70574928798223
5350,Vengeance: A Love Story,73270,4526,68744,2017.csv,2017,6.177152995769073,93.82284700423092
5351,Te Ata,73236,73236,0,2017.csv,2017,100.0,0.0
5352,Antonio Lopez 1970: Sex Fashion & Disco,73122,43169,29953,2018.csv,2018,59.03695194332759,40.96304805667241
5353,Buster's Mal Heart,73121,73121,0,2017.csv,2017,100.0,0.0
5354,Headshot,73010,0,73010,2017.csv,2017,0.0,100.0
5355,5B,72968,72968,0,2019.csv,2019,100.0,0.0
5356,Do Not Resist,72791,72791,0,2016.csv,2016,100.0,0.0
5357,The Green Wave,72152,0,72152,2011.csv,2011,0.0,100.0
5358,Partisan,72151,0,72151,2015.csv,2015,0.0,100.0
5359,After Tiller,72125,72125,0,2013.csv,2013,100.0,0.0
5360,Veil of Tears,72078,72078,0,2014.csv,2014,100.0,0.0
5361,The Invisible War,71968,71968,0,2012.csv,2012,100.0,0.0
5362,The Chambermaid Lynn,71918,315,71603,2015.csv,2015,0.4379988320031147,99.56200116799688
5363,Raiders!: The Story of the Greatest Fan Film Ever Made,71916,71916,0,2016.csv,2016,100.0,0.0
5364,Come and See 2020 Re-release,71909,71909,0,2020.csv,2020,100.0,0.0
5365,An Oversimplification of Her Beauty,71906,71906,0,2013.csv,2013,100.0,0.0
5366,As I Lay Dying,71759,16697,55062,2013.csv,2013,23.268161484970527,76.73183851502947
5367,Runaway Slave,71737,71737,0,2012.csv,2012,100.0,0.0
5368,Flamenco Flamenco 2014 Re-release,71732,71732,0,2014.csv,2014,100.0,0.0
5369,"Je t'aime, je t'aime 2014 Re-release",71717,71717,0,2014.csv,2014,100.0,0.0
5370,Eisenstein in Guanajuato 2015 Re-release,71570,34282,37288,2016.csv,2016,47.89995808299567,52.10004191700433
5371,The Congressman,71451,71451,0,2016.csv,2016,100.0,0.0
5372,The Sicilian Girl 2010 Re-release,71239,71239,0,2010.csv,2010,100.0,0.0
5373,My Journey Through French Cinema,71174,52214,18960,2016.csv,2016,73.3610588136117,26.638941186388287
5374,Free Trip to Egypt 2019 Re-release,71087,71087,0,2019.csv,2019,100.0,0.0
5375,Rosencrantz and Guildenstern Are Undead,71007,71007,0,2010.csv,2010,100.0,0.0
5376,Freaks of Nature,70958,70958,0,2015.csv,2015,100.0,0.0
5377,Norman Lear: Just Another Version of You,70950,70950,0,2016.csv,2016,100.0,0.0
5378,The Better Angels,70918,70918,0,2014.csv,2014,100.0,0.0
5379,4:44 Last Day on Earth,70851,17801,53050,2012.csv,2012,25.124557169270723,74.87544283072928
5380,Miss Lovely,70845,0,70845,2014.csv,2014,0.0,100.0
5381,How to Build a Girl,70632,70632,0,2020.csv,2020,100.0,0.0
5382,Seasons of Gray,70605,70605,0,2013.csv,2013,100.0,0.0
5383,Fireflies in the Garden 2011 Re-release,70600,70600,0,2011.csv,2011,100.0,0.0
5384,Go for Sisters,70495,70495,0,2013.csv,2013,100.0,0.0
5385,The Fog 2018 Re-release,70421,70421,0,2018.csv,2018,100.0,0.0
5386,Over Your Cities Grass Will Grow,70256,51301,18955,2010.csv,2010,73.02009792757914,26.97990207242086
5387,Wastelander,70045,70045,0,2018.csv,2018,100.0,0.0
5388,Nick Mason's Saucerful of Secrets: Live at the Roundhouse,69967,32444,37523,2020.csv,2020,46.37043177497963,53.629568225020364
5389,Turn It Around: The Story of East Bay Punk,69787,69787,0,2017.csv,2017,100.0,0.0
5390,Assassination of a High School President,69564,0,69564,2010.csv,2010,0.0,100.0
5391,Chef Flynn,69542,68407,1135,2018.csv,2018,98.36789278421674,1.6321072157832677
5392,Back to the Jurassic,69423,4351,65072,2015.csv,2015,6.26737536551287,93.73262463448712
5393,An Inconsistent Truth,69394,69394,0,2012.csv,2012,100.0,0.0
5394,Siddharth,69310,60537,8773,2014.csv,2014,87.34237483768575,12.65762516231424
5395,Rocky Handsome,69289,0,69289,2016.csv,2016,0.0,100.0
5396,Bajatey Raho,69085,55397,13688,2013.csv,2013,80.18672649634509,19.81327350365492
5397,The White Sheik 2019 re-release,68940,50850,18090,2019.csv,2019,73.7597911227154,26.240208877284594
5398,My Entire High School Sinking Into the Sea,68883,68883,0,2017.csv,2017,100.0,0.0
5399,Klown 2012 Re-release,68795,68795,0,2012.csv,2012,100.0,0.0
5400,Strange Powers: Stephin Merritt and the Magnetic Fields,68719,68719,0,2010.csv,2010,100.0,0.0
5401,Noma: My Perfect Storm,68622,21130,47492,2015.csv,2015,30.791874326017894,69.2081256739821
5402,Take Me to the River,68598,68598,0,2014.csv,2014,100.0,0.0
5403,Mastizaade,68583,43403,25180,2016.csv,2016,63.285362261785,36.71463773821501
5404,Wildflower,68577,18062,50515,2016.csv,2016,26.338276681686278,73.66172331831372
5405,Outside In,68492,68492,0,2018.csv,2018,100.0,0.0
5406,Alive and Kicking,68485,68485,0,2017.csv,2017,100.0,0.0
5407,Last Year at Marienbad 2019 Re-release,68402,63425,4977,2019.csv,2019,92.72389696207713,7.276103037922868
5408,Budrus,68353,68353,0,2010.csv,2010,100.0,0.0
5409,2012: Time for Change,68339,68339,0,2010.csv,2010,100.0,0.0
5410,The Eyes of Orson Welles,68328,10253,58075,2018.csv,2018,15.005561409670998,84.994438590329
5411,10x10,68260,2263,65997,2018.csv,2018,3.3152651626135365,96.68473483738647
5412,Maidentrip,68243,68243,0,2013.csv,2013,100.0,0.0
5413,Le Amiche,68167,68167,0,2010.csv,2010,100.0,0.0
5414,¡He matado a mi marido!,68017,45777,22240,2019.csv,2019,67.30229207404031,32.69770792595968
5415,I Am Big Bird: The Caroll Spinney Story,67845,67845,0,2015.csv,2015,100.0,0.0
5416,The Messenger,67816,67816,0,2015.csv,2015,100.0,0.0
5417,Pray: The Story of Patrick Peyton,67814,67814,0,2020.csv,2020,100.0,0.0
5418,Summer in the Forest,67743,45542,22201,2017.csv,2017,67.22761023279158,32.77238976720842
5419,Sanam Teri Kasam,67736,22121,45615,2016.csv,2016,32.6576709578363,67.3423290421637
5420,The Greasy Strangler,67427,45878,21549,2016.csv,2016,68.04099248075697,31.95900751924303
5421,For No Good Reason,67421,67421,0,2014.csv,2014,100.0,0.0
5422,Making the Five Heartbeats,67415,67415,0,2018.csv,2018,100.0,0.0
5423,Being Frank,67343,67343,0,2019.csv,2019,100.0,0.0
5424,The Doctor from India,67136,67136,0,2018.csv,2018,100.0,0.0
5425,The Sun Behind the Clouds: Tibet's Struggle for Freedom,67095,67095,0,2010.csv,2010,100.0,0.0
5426,The Autobiography of Nicolae Ceausescu,67093,34023,33070,2010.csv,2010,50.71020821844306,49.28979178155694
5427,Turbo Kid,67069,67069,0,2015.csv,2015,100.0,0.0
5428,Side by Side,67054,58825,8229,2012.csv,2012,87.72780147343931,12.272198526560683
5429,"3100, Run and Become",66789,65524,1265,2018.csv,2018,98.10597553489347,1.8940244651065294
5430,Max Rose,66680,66680,0,2016.csv,2016,100.0,0.0
5431,Pandora's Promise,66680,66680,0,2013.csv,2013,100.0,0.0
5432,King Georges,66175,66175,0,2016.csv,2016,100.0,0.0
5433,Dancing Across Borders,66166,66166,0,2010.csv,2010,100.0,0.0
5434,Out in the Dark,66017,26966,39051,2013.csv,2013,40.84705454655619,59.152945453443806
5435,All My Life,65852,0,65852,2020.csv,2020,0.0,100.0
5436,D-Day,65536,0,65536,2013.csv,2013,0.0,100.0
5437,Architects of Denial,65424,65424,0,2017.csv,2017,100.0,0.0
5438,Sing Your Song,65310,47718,17592,2012.csv,2012,73.0638493339458,26.936150666054203
5439,You've Been Trumped,65220,29273,35947,2012.csv,2012,44.88347132781356,55.11652867218645
5440,Through a Lens Darkly: Black Photographers and the Emergence of a People,65169,65169,0,2014.csv,2014,100.0,0.0
5441,The Lesson,65142,9045,56097,2015.csv,2015,13.885051119093673,86.11494888090633
5442,Racing Dreams,65082,65082,0,2010.csv,2010,100.0,0.0
5443,Toys in the Attic 2012 Re-release,64918,64918,0,2012.csv,2012,100.0,0.0
5444,Manolo: the Boy Who Made Shoes for Lizards,64889,60056,4833,2017.csv,2017,92.55189631524604,7.448103684753965
5445,Searching for Ingmar Bergman,64742,36686,28056,2018.csv,2018,56.66491612863366,43.33508387136635
5446,The Jesus Rolls,64648,18169,46479,2019.csv,2019,28.10450439302067,71.89549560697934
5447,"Monrovia, Indiana",64596,63944,652,2018.csv,2018,98.99064957582513,1.0093504241748714
5448,Battle of the Brides,64572,64572,0,2011.csv,2011,100.0,0.0
5449,Let the Fire Burn,64489,64489,0,2013.csv,2013,100.0,0.0
5450,Badmaa$h Company,64398,0,64398,2010.csv,2010,0.0,100.0
5451,Paulette 2015 Re-release,64125,29494,34631,2015.csv,2015,45.994541910331385,54.005458089668615
5452,Girl Asleep,64056,60289,3767,2016.csv,2016,94.11920819283127,5.880791807168728
5453,Making Waves: The Art of Cinematic Sound,63998,53144,10854,2019.csv,2019,83.04009500296884,16.95990499703116
5454,Jealousy,63946,63946,0,2014.csv,2014,100.0,0.0
5455,The Details,63595,63595,0,2012.csv,2012,100.0,0.0
5456,A Liar's Autobiography: The Untrue Story of Monty Python's Graham Chapman,63469,5102,58367,2012.csv,2012,8.038570010556334,91.96142998944367
5457,I Smile Back,63373,58738,4635,2015.csv,2015,92.68615972101684,7.313840278983164
5458,Trapped,63241,63241,0,2016.csv,2016,100.0,0.0
5459,The Last of the Unjust,63136,40563,22573,2013.csv,2013,64.24702230106438,35.75297769893563
5460,No Tears for the Dead,63063,63063,0,2014.csv,2014,100.0,0.0
5461,Creative Control,63014,63014,0,2016.csv,2016,100.0,0.0
5462,"Love, Antosha",62900,50168,12732,2019.csv,2019,79.758346581876,20.241653418124006
5463,The Gardener,62734,62734,0,2018.csv,2018,100.0,0.0
5464,The Swan,62716,2367,60349,2018.csv,2018,3.77415651508387,96.22584348491613
5465,Cool It,62713,62713,0,2010.csv,2010,100.0,0.0
5466,Drunk Stoned Brilliant Dead,62660,62660,0,2015.csv,2015,100.0,0.0
5467,The Tiger Hunter,62398,62398,0,2017.csv,2017,100.0,0.0
5468,Mifune: The Last Samurai,62279,62279,0,2016.csv,2016,100.0,0.0
5469,Public Speaking,62173,62173,0,2011.csv,2011,100.0,0.0
5470,Trigun: Badlands Rumble 2011 Re-release,62027,62027,0,2011.csv,2011,100.0,0.0
5471,Kites The Remix,61997,41783,20214,2010.csv,2010,67.39519654176816,32.60480345823185
5472,"I, Me aur Main",61863,0,61863,2013.csv,2013,0.0,100.0
5473,Dark Star: HR Gigers Welt,61845,61845,0,2015.csv,2015,100.0,0.0
5474,In a Valley of Violence,61797,61797,0,2016.csv,2016,100.0,0.0
5475,If a Tree Falls: A Story of the Earth Liberation Front,61794,61794,0,2011.csv,2011,100.0,0.0
5476,River Runs Red,61789,9893,51896,2018.csv,2018,16.01094045865769,83.98905954134231
5477,Amour Fou,61693,13702,47991,2014.csv,2014,22.209975199779553,77.79002480022045
5478,Quill: The Life of a Guide Dog 2012 Re-release,61674,15674,46000,2012.csv,2012,25.414275059182152,74.58572494081784
5479,Backwards,61465,61465,0,2012.csv,2012,100.0,0.0
5480,Donald Cried,61406,61406,0,2017.csv,2017,100.0,0.0
5481,Here and Now,61271,13892,47379,2018.csv,2018,22.673042711886538,77.32695728811346
5482,Never Goin' Back,61271,61271,0,2018.csv,2018,100.0,0.0
5483,The Seasons In Quincy: Four Portraits of John Berger,61267,28456,32811,2016.csv,2016,46.445884407593,53.554115592407
5484,The Outcasts,61250,1455,59795,2017.csv,2017,2.3755102040816327,97.62448979591836
5485,The Untamed,61249,27593,33656,2017.csv,2017,45.050531437247955,54.949468562752045
5486,The Mountain,61035,61035,0,2019.csv,2019,100.0,0.0
5487,The Bodyguard 2012 Re-release,61020,61020,0,2012.csv,2012,100.0,0.0
5488,The Sacrifice 2017 Re-release,61018,61018,0,2017.csv,2017,100.0,0.0
5489,Independent Lens: Don't Stop Believin': Everyman's Journey,61018,61018,0,2013.csv,2013,100.0,0.0
5490,Love U... Mr. Kalakaar!,60956,48557,12399,2011.csv,2011,79.65909836603451,20.340901633965483
5491,The Wicker Man 2013 Re-release,60891,60891,0,2013.csv,2013,100.0,0.0
5492,It's a Disaster,60818,60818,0,2013.csv,2013,100.0,0.0
5493,A Kid Like Jake,60784,58403,2381,2018.csv,2018,96.08285075019742,3.9171492498025797
5494,Apprentice,60752,2578,58174,2016.csv,2016,4.2434816960758495,95.75651830392415
5495,How to Live Forever,60630,60630,0,2011.csv,2011,100.0,0.0
5496,Viper Club,60607,60607,0,2018.csv,2018,100.0,0.0
5497,Too Late,60438,60438,0,2016.csv,2016,100.0,0.0
5498,Limelight,60335,60335,0,2011.csv,2011,100.0,0.0
5499,Crime After Crime,60291,60291,0,2011.csv,2011,100.0,0.0
5500,Wetlands 2014 Re-release,60230,59478,752,2014.csv,2014,98.75145276440313,1.2485472355968787
5501,Presenting Princess Shaw,60197,60197,0,2016.csv,2016,100.0,0.0
5502,Just One Drop,60078,60078,0,2017.csv,2017,100.0,0.0
5503,Gregory Crewdson: Brief Encounters,60064,60064,0,2012.csv,2012,100.0,0.0
5504,Decoding Annie Parker,60048,48390,11658,2014.csv,2014,80.58553157474022,19.41446842525979
5505,The Force,59912,59912,0,2017.csv,2017,100.0,0.0
5506,John Fogerty: 50 Year Trip - Live at Red Rocks,59795,59795,0,2019.csv,2019,100.0,0.0
5507,Frontera,59696,59696,0,2014.csv,2014,100.0,0.0
5508,The Extraordinary Voyage,59424,52986,6438,2012.csv,2012,89.16599353796445,10.834006462035541
5509,Cheap Thrills,59424,59424,0,2014.csv,2014,100.0,0.0
5510,Sweet Dreams,59403,59403,0,2013.csv,2013,100.0,0.0
5511,My Brothers' Crossing,59395,59395,0,2020.csv,2020,100.0,0.0
5512,Bomb City,59329,59329,0,2018.csv,2018,100.0,0.0
5513,Bang! The Bert Berns Story,59299,59299,0,2017.csv,2017,100.0,0.0
5514,Saint Frances,59257,44330,14927,2020.csv,2020,74.80972712084647,25.190272879153518
5515,Digimon Adventure tri. Part 4: Loss,59114,59114,0,2018.csv,2018,100.0,0.0
5516,The Trials of Muhammad Ali,59081,59081,0,2013.csv,2013,100.0,0.0
5517,The One I Wrote for You,58872,58872,0,2014.csv,2014,100.0,0.0
5518,Sagrada: The Mystery of Creation 2014 Re-release,58755,58755,0,2014.csv,2014,100.0,0.0
5519,The Conformist 2014 Re-release,58657,58657,0,2014.csv,2014,100.0,0.0
5520,Horn from the Heart: The Paul Butterfield Story,58597,58597,0,2018.csv,2018,100.0,0.0
5521,Putty Hill,58585,49918,8667,2011.csv,2011,85.2061107792097,14.793889220790305
5522,Orlando 2010 Re-release,58198,58198,0,2010.csv,2010,100.0,0.0
5523,Cynthia,58177,58177,0,2018.csv,2018,100.0,0.0
5524,Faust,58132,58132,0,2013.csv,2013,100.0,0.0
5525,In Search of Greatness,58090,58090,0,2018.csv,2018,100.0,0.0
5526,The Boom,57962,57962,0,2017.csv,2017,100.0,0.0
5527,Rififi 2015 Re-release,57749,57749,0,2015.csv,2015,100.0,0.0
5528,Command and Control,57635,57635,0,2016.csv,2016,100.0,0.0
5529,Battleship Potemkin,57620,51198,6422,2011.csv,2011,88.8545643873655,11.145435612634502
5530,Playback,57587,264,57323,2012.csv,2012,0.458436799972216,99.54156320002778
5531,Sold,57527,57527,0,2016.csv,2016,100.0,0.0
5532,Court,57416,22898,34518,2015.csv,2015,39.8808694440574,60.11913055594259
5533,Ramen Heads,57345,57345,0,2018.csv,2018,100.0,0.0
5534,Run & Jump,57189,20061,37128,2014.csv,2014,35.07842417248072,64.92157582751928
5535,Mickey and the Bear,57188,57188,0,2019.csv,2019,100.0,0.0
5536,My Joy,56857,6298,50559,2011.csv,2011,11.076912253548375,88.92308774645163
5537,The Battle of Algiers 2016 Re-release,56853,56853,0,2016.csv,2016,100.0,0.0
5538,Farmageddon,56573,56573,0,2011.csv,2011,100.0,0.0
5539,Muran,56493,30116,26377,2011.csv,2011,53.30925955428106,46.69074044571894
5540,Beyond the Black Rainbow,56491,56491,0,2012.csv,2012,100.0,0.0
5541,Big Men,56286,56286,0,2014.csv,2014,100.0,0.0
5542,Saving Brinton,56218,56218,0,2017.csv,2017,100.0,0.0
5543,Wedding Doll,56196,56196,0,2016.csv,2016,100.0,0.0
5544,Notebook,56166,0,56166,2019.csv,2019,0.0,100.0
5545,False Confessions,56165,29245,26920,2017.csv,2017,52.06979435591561,47.930205644084396
5546,Évolution,55985,24770,31215,2016.csv,2016,44.24399392694472,55.75600607305529
5547,Vitalina Varela,55862,14941,40921,2019.csv,2019,26.74626758798468,73.25373241201532
5548,Terms and Conditions May Apply,55824,55824,0,2013.csv,2013,100.0,0.0
5549,Hellion,55708,55708,0,2014.csv,2014,100.0,0.0
5550,XX,55668,30911,24757,2017.csv,2017,55.52741251706546,44.472587482934536
5551,Recorder: The Marion Stokes Project,55632,55632,0,2019.csv,2019,100.0,0.0
5552,Holidays,55621,0,55621,2016.csv,2016,0.0,100.0
5553,As Good as Dead,55618,1981,53637,2010.csv,2010,3.561796540688266,96.43820345931174
5554,Finding Joe,55518,55518,0,2011.csv,2011,100.0,0.0
5555,Entertainment,55506,55506,0,2015.csv,2015,100.0,0.0
5556,Naam Shabana,55429,0,55429,2017.csv,2017,0.0,100.0
5557,Into Eternity,55366,55366,0,2011.csv,2011,100.0,0.0
5558,C.O.G.,55301,55301,0,2013.csv,2013,100.0,0.0
5559,Natural Selection,55282,55282,0,2012.csv,2012,100.0,0.0
5560,Mamma Mia! 2018 Re-release,55168,39601,15567,2018.csv,2018,71.78255510440835,28.217444895591647
5561,American Dream: Detroit,55092,55092,0,2018.csv,2018,100.0,0.0
5562,The Lovely Month of May,55038,55038,0,2013.csv,2013,100.0,0.0
5563,Zombeavers,54985,14947,40038,2014.csv,2014,27.183777393834685,72.81622260616531
5564,DAZN Boxing: Canelo Alvarez vs. Rocky Fielding,54916,54916,0,2018.csv,2018,100.0,0.0
5565,Snowmen,54805,54805,0,2011.csv,2011,100.0,0.0
5566,The Nature of Existence,54645,54645,0,2010.csv,2010,100.0,0.0
5567,What Our Fathers Did: A Nazi Legacy,54603,40119,14484,2015.csv,2015,73.4739849458821,26.526015054117906
5568,The Lottery,54543,54543,0,2010.csv,2010,100.0,0.0
5569,The Harimaya Bridge,54473,54473,0,2010.csv,2010,100.0,0.0
5570,A Simple Wedding,54415,54415,0,2020.csv,2020,100.0,0.0
5571,Digimon Adventure tri. Part 6: Future,54324,54324,0,2018.csv,2018,100.0,0.0
5572,Harlan: In the Shadow of Jew Suess,54305,54305,0,2010.csv,2010,100.0,0.0
5573,The Search for General Tso,54275,54275,0,2015.csv,2015,100.0,0.0
5574,Wagner & Me 2012 Re-release,54215,37745,16470,2012.csv,2012,69.62095361062437,30.379046389375635
5575,Line of Duty,54204,54204,0,2013.csv,2013,100.0,0.0
5576,Last Passenger,54110,14806,39304,2014.csv,2014,27.362779523193492,72.6372204768065
5577,Low Down,54051,54051,0,2014.csv,2014,100.0,0.0
5578,A Beautiful Soul,54008,54008,0,2012.csv,2012,100.0,0.0
5579,Surviving Progress,53953,53953,0,2012.csv,2012,100.0,0.0
5580,The Assassin's Code,53940,11218,42722,2018.csv,2018,20.797182054134222,79.20281794586577
5581,The Last Man on the Moon,53881,52482,1399,2016.csv,2016,97.40353742506635,2.59646257493365
5582,The Summer of Sangaile,53843,4480,49363,2015.csv,2015,8.320487342830079,91.67951265716991
5583,At Middleton,53837,53837,0,2014.csv,2014,100.0,0.0
5584,Rising from Ashes,53804,38602,15202,2013.csv,2013,71.74559512303918,28.25440487696082
5585,The Heir Apparent: Largo Winch 2011 Re-release,53793,10352,43441,2011.csv,2011,19.24413957206328,80.75586042793672
5586,Down by Love,53780,675,53105,2016.csv,2016,1.25511342506508,98.74488657493492
5587,The Legend of Hallowaiian,53738,451,53287,2018.csv,2018,0.839257136476981,99.16074286352303
5588,The Other F Word,53714,53714,0,2011.csv,2011,100.0,0.0
5589,Leonie 2013 Re-release,53692,53692,0,2013.csv,2013,100.0,0.0
5590,Grass,53503,8084,45419,2018.csv,2018,15.109433115900043,84.89056688409995
5591,God of Vampires,53345,53345,0,2010.csv,2010,100.0,0.0
5592,The Great Silence,53074,53074,0,2018.csv,2018,100.0,0.0
5593,Love Thy Nature,52947,41149,11798,2015.csv,2015,77.71733998149092,22.282660018509077
5594,Ping Pong Summer,52909,52909,0,2014.csv,2014,100.0,0.0
5595,Mia and the Migoo 2010 Re-release,52873,17000,35873,2010.csv,2010,32.152516407239986,67.84748359276
5596,To Be Takei,52823,52823,0,2014.csv,2014,100.0,0.0
5597,Occupy Unmasked,52768,52768,0,2012.csv,2012,100.0,0.0
5598,!Women Art Revolution,52681,52681,0,2011.csv,2011,100.0,0.0
5599,Salvation Army,52511,3929,48582,2014.csv,2014,7.482241816000457,92.51775818399955
5600,Cropsey,52476,52476,0,2010.csv,2010,100.0,0.0
5601,Going Attractions: The Definitive Story of the American Drive-in Movie,52458,52458,0,2013.csv,2013,100.0,0.0
5602,A Tale of Winter,52431,23268,29163,2014.csv,2014,44.37832579962236,55.62167420037763
5603,Breath Made Visible: Anna Halprin,52387,52387,0,2010.csv,2010,100.0,0.0
5604,Birdboy: The Forgotten Children,52366,38786,13580,2017.csv,2017,74.06714280258183,25.932857197418173
5605,Here and There,52307,27156,25151,2010.csv,2010,51.91656948400788,48.08343051599213
5606,The Human Experience,52296,52296,0,2010.csv,2010,100.0,0.0
5607,Henri-Georges Clouzot's Inferno,52003,25489,26514,2010.csv,2010,49.01447993384997,50.98552006615002
5608,American Dharma,51891,51891,0,2019.csv,2019,100.0,0.0
5609,Quay,51858,51858,0,2015.csv,2015,100.0,0.0
5610,The Snowman Trek,51743,51743,0,2018.csv,2018,100.0,0.0
5611,Wanda 2018 Re-release,51713,51713,0,2018.csv,2018,100.0,0.0
5612,Midnight Family,51712,42310,9402,2019.csv,2019,81.81853341584159,18.181466584158414
5613,Tickling Giants,51499,51499,0,2017.csv,2017,100.0,0.0
5614,The Yes Men Are Revolting,51331,50190,1141,2015.csv,2015,97.77717168962225,2.222828310377744
5615,Venus and Serena,51271,51271,0,2013.csv,2013,100.0,0.0
5616,God Loves Uganda,51229,51229,0,2013.csv,2013,100.0,0.0
5617,Miss Fisher & the Crypt of Tears Special Screenings,51158,51032,126,2020.csv,2020,99.75370421048517,0.24629578951483638
5618,An Invisible Sign,51138,1279,49859,2011.csv,2011,2.501075521138879,97.49892447886111
5619,The Unknowns,51035,51035,0,2016.csv,2016,100.0,0.0
5620,The Good Doctor,51017,5206,45811,2012.csv,2012,10.204441656702667,89.79555834329733
5621,As I Open My Eyes,50721,30989,19732,2016.csv,2016,61.09698152638946,38.90301847361054
5622,House of Cardin,50659,0,50659,2020.csv,2020,0.0,100.0
5623,Keep Quiet,50451,50451,0,2017.csv,2017,100.0,0.0
5624,Clinton Road,50400,50400,0,2019.csv,2019,100.0,0.0
5625,Wake in Fright 2012 Re-release,50394,50394,0,2012.csv,2012,100.0,0.0
5626,Midnight Traveler,50336,41265,9071,2019.csv,2019,81.97910044500954,18.020899554990464
5627,The Fitzgerald Family Christmas,50292,50292,0,2012.csv,2012,100.0,0.0
5628,The Royal Wedding: Prince Harry and Meghan Markle,50264,50264,0,2018.csv,2018,100.0,0.0
5629,The Retrieval,50257,50257,0,2014.csv,2014,100.0,0.0
5630,In Order of Disappearance 2016 Re-release,50251,50251,0,2016.csv,2016,100.0,0.0
5631,Quest,50022,47807,2215,2017.csv,2017,95.5719483427292,4.428051657270801
5632,The Discoverers,50020,50020,0,2014.csv,2014,100.0,0.0
5633,Bigger,49997,46382,3615,2018.csv,2018,92.76956617397045,7.230433826029562
5634,Spring,49970,49970,0,2015.csv,2015,100.0,0.0
5635,Free Trip to Egypt,49693,49693,0,2019.csv,2019,100.0,0.0
5636,Henchmen 2020 Re-release,49676,49676,0,2020.csv,2020,100.0,0.0
5637,NOW: In the Wings on a World Stage,49591,49591,0,2014.csv,2014,100.0,0.0
5638,Red Herring,49480,49480,0,2015.csv,2015,100.0,0.0
5639,GasLand,49428,30846,18582,2010.csv,2010,62.40592376790484,37.59407623209517
5640,Jumanji/Jumanji: Welcome to the Jungle 2018 NCM Fathom Event,49381,49381,0,2018.csv,2018,100.0,0.0
5641,Shirin in Love,49254,49254,0,2014.csv,2014,100.0,0.0
5642,Bonsai,49128,21267,27861,2012.csv,2012,43.28895945285784,56.711040547142154
5643,Hal,49045,48698,347,2018.csv,2018,99.29248649199714,0.7075135080028545
5644,The Way I See It,49030,49030,0,2020.csv,2020,100.0,0.0
5645,Orgasm Inc.,49001,49001,0,2011.csv,2011,100.0,0.0
5646,Lucky Them,48995,48995,0,2014.csv,2014,100.0,0.0
5647,The Internet's Own Boy: The Story of Aaron Swartz,48911,48911,0,2014.csv,2014,100.0,0.0
5648,The Seven Five,48869,48869,0,2015.csv,2015,100.0,0.0
5649,The Bounty Killer,48815,48815,0,2019.csv,2019,100.0,0.0
5650,The Citizen,48767,24296,24471,2013.csv,2013,49.82057538909508,50.17942461090491
5651,A Birder's Guide to Everything,48713,48713,0,2014.csv,2014,100.0,0.0
5652,American Mustang,48700,48700,0,2014.csv,2014,100.0,0.0
5653,Tales from Earthsea 2010 Re-release,48658,48658,0,2010.csv,2010,100.0,0.0
5654,The China Hustle,48650,48650,0,2018.csv,2018,100.0,0.0
5655,Person to Person,48499,48499,0,2017.csv,2017,100.0,0.0
5656,Alleluia,48426,6334,42092,2014.csv,2014,13.079750547226695,86.9202494527733
5657,Boogie Woogie,48411,2618,45793,2010.csv,2010,5.407861849579641,94.59213815042035
5658,"Lebanon, Pa.",48381,48381,0,2011.csv,2011,100.0,0.0
5659,Ceremony,48174,22270,25904,2011.csv,2011,46.22825590567526,53.77174409432474
5660,The Forbidden Room,48082,34404,13678,2015.csv,2015,71.55276402811863,28.44723597188137
5661,Life Happens,48041,30905,17136,2012.csv,2012,64.33046772548448,35.66953227451552
5662,A Cop,48040,48040,0,2013.csv,2013,100.0,0.0
5663,Saving Banksy,47965,47965,0,2017.csv,2017,100.0,0.0
5664,The Queen,47818,47818,0,2019.csv,2019,100.0,0.0
5665,Alphaville,47696,47696,0,2014.csv,2014,100.0,0.0
5666,So B. It,47627,47627,0,2017.csv,2017,100.0,0.0
5667,GMO OMG,47558,47558,0,2013.csv,2013,100.0,0.0
5668,350 Days - Legends. Champions. Survivors,47526,47526,0,2018.csv,2018,100.0,0.0
5669,Entre les Bras,47439,47439,0,2012.csv,2012,100.0,0.0
5670,Alabama Moon,47305,47305,0,2011.csv,2011,100.0,0.0
5671,Daughters of the Dust 2016 Re-release,47287,40986,6301,2016.csv,2016,86.67498466809059,13.325015331909404
5672,The Raft,47269,39678,7591,2019.csv,2019,83.94084918233938,16.059150817660623
5673,Every Man for Himself,47262,47262,0,2010.csv,2010,100.0,0.0
5674,Went the Day Well?,47214,47214,0,2011.csv,2011,100.0,0.0
5675,VHYes,47037,47037,0,2020.csv,2020,100.0,0.0
5676,Diary of a Country Priest,47000,47000,0,2011.csv,2011,100.0,0.0
5677,A Master Builder,46874,46874,0,2014.csv,2014,100.0,0.0
5678,Enter the Fat Dragon,46855,46855,0,2020.csv,2020,100.0,0.0
5679,78/52: Hitchcock's Shower Scene,46838,37664,9174,2017.csv,2017,80.41333959605448,19.586660403945512
5680,"Connected: An Autoblogography About Love, Death & Technology",46782,46782,0,2011.csv,2011,100.0,0.0
5681,The Woodmans,46623,46623,0,2011.csv,2011,100.0,0.0
5682,Ca$h,46488,46488,0,2010.csv,2010,100.0,0.0
5683,Our Time,46433,14777,31656,2019.csv,2019,31.824349062089464,68.17565093791053
5684,Shanghai 2015 Re-release,46425,46425,0,2015.csv,2015,100.0,0.0
5685,Patience,46410,15941,30469,2012.csv,2012,34.34820081878905,65.65179918121095
5686,Mediterranea,46392,22076,24316,2015.csv,2015,47.58579065356096,52.414209346439044
5687,William S. Burroughs: A Man Within,46380,46380,0,2010.csv,2010,100.0,0.0
5688,The Bra,46316,7324,38992,2019.csv,2019,15.813109940409362,84.18689005959064
5689,Greedy Lying Bastards,46121,45000,1121,2012.csv,2012,97.56943691593851,2.4305630840614905
5690,Ballplayer: Pelotero,46109,46109,0,2012.csv,2012,100.0,0.0
5691,Panique,46041,46041,0,2017.csv,2017,100.0,0.0
5692,Every Day,46029,46029,0,2011.csv,2011,100.0,0.0
5693,Monk with a Camera,45938,45938,0,2014.csv,2014,100.0,0.0
5694,Maurice 2017 Re-release,45926,45926,0,2017.csv,2017,100.0,0.0
5695,High on the Hog,45696,45696,0,2019.csv,2019,100.0,0.0
5696,Eddie: The Sleepwalking Cannibal,45604,1632,43972,2012.csv,2012,3.5786334532058595,96.42136654679415
5697,3 Weeks in Yerevan,45536,45536,0,2016.csv,2016,100.0,0.0
5698,An Eye for Beauty,45513,9395,36118,2015.csv,2015,20.64245380440753,79.35754619559246
5699,Mercury,45429,0,45429,2018.csv,2018,0.0,100.0
5700,Return to the Hiding Place,45405,45405,0,2014.csv,2014,100.0,0.0
5701,Ai Weiwei: The Fake Case,45255,45255,0,2014.csv,2014,100.0,0.0
5702,There's No Place Like Utopia,45254,45254,0,2014.csv,2014,100.0,0.0
5703,CornerStore,45176,45176,0,2011.csv,2011,100.0,0.0
5704,American Made Movie,45175,45175,0,2013.csv,2013,100.0,0.0
5705,The Proposal,45149,45149,0,2019.csv,2019,100.0,0.0
5706,The Farthest,44921,14773,30148,2017.csv,2017,32.88662318292113,67.11337681707887
5707,Celebration,44898,22557,22341,2019.csv,2019,50.24054523586797,49.75945476413203
5708,The Pruitt-Igoe Myth,44883,44883,0,2012.csv,2012,100.0,0.0
5709,River of Fundament,44840,44840,0,2015.csv,2015,100.0,0.0
5710,Union Square,44830,44830,0,2012.csv,2012,100.0,0.0
5711,That Summer,44659,34556,10103,2018.csv,2018,77.37746031035178,22.622539689648224
5712,The Dog,44581,44581,0,2014.csv,2014,100.0,0.0
5713,The Bride Wore Black,44566,44566,0,2011.csv,2011,100.0,0.0
5714,What Is Democracy?,44536,44536,0,2019.csv,2019,100.0,0.0
5715,"Léon Morin, Priest 2017 Re-release",44511,44511,0,2017.csv,2017,100.0,0.0
5716,Defendor,44462,44462,0,2010.csv,2010,100.0,0.0
5717,Maze 2019 Re-release,44381,44381,0,2019.csv,2019,100.0,0.0
5718,What You Gonna Do When the World's on Fire?,44290,4672,39618,2019.csv,2019,10.548656581621135,89.45134341837887
5719,Carmine Street Guitars,44253,44253,0,2019.csv,2019,100.0,0.0
5720,Slut in a Good Way,44240,40513,3727,2019.csv,2019,91.5754972875226,8.424502712477395
5721,Nuts!,44230,44230,0,2016.csv,2016,100.0,0.0
5722,Danny Says,44213,44213,0,2016.csv,2016,100.0,0.0
5723,Life of a King,44161,6547,37614,2014.csv,2014,14.825298340164398,85.1747016598356
5724,Hermia & Helena,44156,43152,1004,2017.csv,2017,97.72624331914123,2.2737566808587735
5725,Submission,44069,39985,4084,2018.csv,2018,90.73271460663959,9.267285393360412
5726,Liyana,44045,44045,0,2018.csv,2018,100.0,0.0
5727,Garry Winogrand: All Things are Photographable,44002,44002,0,2018.csv,2018,100.0,0.0
5728,Granito,43942,43942,0,2011.csv,2011,100.0,0.0
5729,Spree,43840,28771,15069,2020.csv,2020,65.62728102189782,34.37271897810219
5730,Summer 2011 Re-release,43839,43839,0,2011.csv,2011,100.0,0.0
5731,Hitler's Hollywood,43766,43766,0,2018.csv,2018,100.0,0.0
5732,Contempt 2013 Re-release,43763,43763,0,2013.csv,2013,100.0,0.0
5733,Bad Blood 2013 Re-release,43758,35176,8582,2013.csv,2013,80.38758626993922,19.612413730060787
5734,The Land,43756,43756,0,2016.csv,2016,100.0,0.0
5735,Bereavement,43712,43712,0,2011.csv,2011,100.0,0.0
5736,Woodshock,43682,42603,1079,2017.csv,2017,97.52987500572317,2.470124994276819
5737,Love Etc.,43593,43593,0,2011.csv,2011,100.0,0.0
5738,"OC87: The Obsessive Compulsive, Major Depression, Bipolar, Asperger's Movie",43583,43583,0,2012.csv,2012,100.0,0.0
5739,The Graduate 45th Anniversary Reunion,43466,43466,0,2012.csv,2012,100.0,0.0
5740,If You Build It,43393,43393,0,2014.csv,2014,100.0,0.0
5741,The Empire of Corpses,43320,0,43320,2016.csv,2016,0.0,100.0
5742,Next Goal Wins,43089,43089,0,2014.csv,2014,100.0,0.0
5743,3 Backyards,43073,43073,0,2011.csv,2011,100.0,0.0
5744,Jenny's Wedding,42927,4704,38223,2015.csv,2015,10.958138234677476,89.04186176532252
5745,Andre Gregory: Before and After Dinner,42892,42892,0,2013.csv,2013,100.0,0.0
5746,First We Take Brooklyn,42812,42812,0,2018.csv,2018,100.0,0.0
5747,Interior. Leather Bar.,42534,42534,0,2014.csv,2014,100.0,0.0
5748,Last Call at the Oasis,42423,42423,0,2012.csv,2012,100.0,0.0
5749,Fixing the Future,42393,42393,0,2012.csv,2012,100.0,0.0
5750,Closet Monster,42360,42166,194,2016.csv,2016,99.54202077431539,0.4579792256846081
5751,The Oath,42273,42273,0,2010.csv,2010,100.0,0.0
5752,Down for Life,41914,41914,0,2011.csv,2011,100.0,0.0
5753,In Pursuit of Silence,41913,29834,12079,2016.csv,2016,71.18077923317347,28.81922076682652
5754,Golden Exits,41888,41888,0,2018.csv,2018,100.0,0.0
5755,The Nightmare,41853,28281,13572,2015.csv,2015,67.5722170453731,32.42778295462691
5756,On the Bowery,41802,41802,0,2010.csv,2010,100.0,0.0
5757,The Road Within,41760,0,41760,2015.csv,2015,0.0,100.0
5758,Union,41656,41656,0,2019.csv,2019,100.0,0.0
5759,Kalakalappu,41624,30949,10675,2012.csv,2012,74.35373822794543,25.646261772054586
5760,Death of a Superhero,41575,607,40968,2012.csv,2012,1.4600120264582082,98.53998797354178
5761,The Settlers,41562,41562,0,2017.csv,2017,100.0,0.0
5762,Jonathan,41558,0,41558,2018.csv,2018,0.0,100.0
5763,Holla II,41537,41537,0,2013.csv,2013,100.0,0.0
5764,Censored Voices,41260,41260,0,2015.csv,2015,100.0,0.0
5765,Dark Light,41240,0,41240,2019.csv,2019,0.0,100.0
5766,Steve McQueen: The Man & Le Mans,41203,6843,34360,2015.csv,2015,16.608013979564596,83.39198602043541
5767,The Comedy,41113,41113,0,2012.csv,2012,100.0,0.0
5768,Karl Marx City,41072,41072,0,2017.csv,2017,100.0,0.0
5769,Blue Iguana,41050,0,41050,2018.csv,2018,0.0,100.0
5770,The Myth of the American Sleepover,41045,41045,0,2011.csv,2011,100.0,0.0
5771,Fat Kid Rules the World,41000,41000,0,2012.csv,2012,100.0,0.0
5772,Why Don't You Just Die!,40995,0,40995,2019.csv,2019,0.0,100.0
5773,Hell and Back Again,40949,40634,315,2011.csv,2011,99.23075044567634,0.7692495543236709
5774,Found Memories,40729,10575,30154,2012.csv,2012,25.964300621179014,74.03569937882098
5775,Language of a Broken Heart,40645,40645,0,2013.csv,2013,100.0,0.0
5776,Mercedes Sosa: The Voice of Latin America,40643,2648,37995,2013.csv,2013,6.515267081662279,93.48473291833773
5777,Life and Nothing More,40581,24358,16223,2017.csv,2017,60.02316354944433,39.97683645055568
5778,The FP,40557,40557,0,2012.csv,2012,100.0,0.0
5779,CBGB,40400,40400,0,2013.csv,2013,100.0,0.0
5780,Terkel in Trouble 2010 Re-release,40385,40385,0,2010.csv,2010,100.0,0.0
5781,Belle de Jour 2017 Re-release,40382,26331,14051,2017.csv,2017,65.2047942152444,34.79520578475558
5782,Of Mind and Music,40322,15073,25249,2016.csv,2016,37.38157829472745,62.61842170527255
5783,Paan Singh Tomar,40311,40311,0,2012.csv,2012,100.0,0.0
5784,The Red Baron 2010 Re-release,40239,37189,3050,2010.csv,2010,92.42028877457193,7.579711225428068
5785,Teenage,40169,40169,0,2014.csv,2014,100.0,0.0
5786,On Her Shoulders,40145,28288,11857,2018.csv,2018,70.46456594843691,29.535434051563087
5787,Aniara,40124,40124,0,2019.csv,2019,100.0,0.0
5788,Addiction Incorporated,40106,40106,0,2011.csv,2011,100.0,0.0
5789,Humor Me,40099,40099,0,2018.csv,2018,100.0,0.0
5790,Unrest,40081,40081,0,2017.csv,2017,100.0,0.0
5791,Louder Than a Bomb,40000,40000,0,2011.csv,2011,100.0,0.0
5792,Is That a Gun in Your Pocket?,39928,39928,0,2016.csv,2016,100.0,0.0
5793,Divine Love,39920,0,39920,2019.csv,2019,0.0,100.0
5794,The Short Game,39819,39819,0,2013.csv,2013,100.0,0.0
5795,Plot for Peace,39811,7051,32760,2013.csv,2013,17.711185350782447,82.28881464921756
5796,Port of Shadows,39623,27389,12234,2012.csv,2012,69.12399364005755,30.87600635994246
5797,An Elephant Sitting Still,39599,32556,7043,2018.csv,2018,82.21419732821535,17.78580267178464
5798,The Homeless Billionaire,39493,39493,0,2016.csv,2016,100.0,0.0
5799,Juvenile Delinquents,39455,34292,5163,2020.csv,2020,86.9142060575339,13.0857939424661
5800,Prophet's Prey,39347,39347,0,2015.csv,2015,100.0,0.0
5801,Child of God,39324,39324,0,2014.csv,2014,100.0,0.0
5802,"3 1/2 Minutes, 10 Bullets",39263,30407,8856,2015.csv,2015,77.44441331533505,22.555586684664952
5803,La Notte,39236,39236,0,2016.csv,2016,100.0,0.0
5804,Where Soldiers Come From,39201,39201,0,2011.csv,2011,100.0,0.0
5805,How to Make Money Selling Drugs,39192,39192,0,2013.csv,2013,100.0,0.0
5806,I Do Not Care If We Go Down in History as Barbarians,39171,11307,27864,2018.csv,2018,28.86574251359424,71.13425748640576
5807,The Expedition to the End of the World,39115,39115,0,2014.csv,2014,100.0,0.0
5808,Zilla and Zoe,39003,39003,0,2019.csv,2019,100.0,0.0
5809,I Used to Be Darker,38974,22214,16760,2013.csv,2013,56.99697234053471,43.00302765946529
5810,Herb & Dorothy 50X50,38933,38933,0,2013.csv,2013,100.0,0.0
5811,Shed of the Dead,38901,38901,0,2019.csv,2019,100.0,0.0
5812,The Son of Joseph,38774,30588,8186,2016.csv,2016,78.88791458193634,21.11208541806365
5813,Restored Me,38745,38745,0,2016.csv,2016,100.0,0.0
5814,Bluebeard,38696,33490,5206,2010.csv,2010,86.54641306594996,13.45358693405003
5815,Paul Williams Still Alive,38691,38691,0,2012.csv,2012,100.0,0.0
5816,Catching the Sun,38613,38613,0,2016.csv,2016,100.0,0.0
5817,Spa Night,38578,38578,0,2016.csv,2016,100.0,0.0
5818,Troublemakers: The Story of Land Art,38571,29462,9109,2016.csv,2016,76.38381167198153,23.61618832801846
5819,Divide and Conquer,38510,38510,0,2018.csv,2018,100.0,0.0
5820,Death by China,38492,38492,0,2012.csv,2012,100.0,0.0
5821,Multiple Maniacs,38403,33036,5367,2016.csv,2016,86.0245293336458,13.975470666354193
5822,Araby,38399,38399,0,2018.csv,2018,100.0,0.0
5823,Batman Forever 2019 Re-release,38387,38014,373,2019.csv,2019,99.02831687810978,0.9716831218902232
5824,Nine Nation Animation,38382,38382,0,2010.csv,2010,100.0,0.0
5825,The Blackcoat's Daughter,38348,20435,17913,2017.csv,2017,53.28830708250756,46.711692917492435
5826,Policeman,38263,11263,27000,2013.csv,2013,29.435747327705613,70.56425267229439
5827,No Intenso Agora,38223,24955,13268,2018.csv,2018,65.28791565287916,34.71208434712084
5828,Germans & Jews,38100,38100,0,2016.csv,2016,100.0,0.0
5829,The Legend of Pale Male,38083,38083,0,2010.csv,2010,100.0,0.0
5830,Gray Matter,38034,38034,0,2018.csv,2018,100.0,0.0
5831,Band of Outsiders 2016 Re-release,38004,38004,0,2016.csv,2016,100.0,0.0
5832,Moscow Never Sleeps,38004,25306,12698,2016.csv,2016,66.58772760762025,33.41227239237975
5833,The Crime of Monsieur Lange,38002,36438,1564,2017.csv,2017,95.88442713541393,4.115572864586074
5834,Russian Ark 2013 Re-release,37984,37984,0,2013.csv,2013,100.0,0.0
5835,Adult World,37887,25368,12519,2014.csv,2014,66.95700372159315,33.04299627840684
5836,I Am the Blues,37849,37849,0,2017.csv,2017,100.0,0.0
5837,The Heart of Nuba,37788,37788,0,2018.csv,2018,100.0,0.0
5838,Out 1,37743,31539,6204,2015.csv,2015,83.5625149034258,16.4374850965742
5839,Mumia: Long Distance Revolutionary,37731,37731,0,2013.csv,2013,100.0,0.0
5840,Krystal,37516,37516,0,2018.csv,2018,100.0,0.0
5841,News from Planet Mars,37507,310,37197,2016.csv,2016,0.8265123843549204,99.17348761564509
5842,Big Sur,37466,37466,0,2013.csv,2013,100.0,0.0
5843,Match 2015 Re-release,37285,37285,0,2015.csv,2015,100.0,0.0
5844,Memory: The Origins of Alien,37272,31378,5894,2019.csv,2019,84.18652071259926,15.81347928740073
5845,Savannah,37240,37240,0,2013.csv,2013,100.0,0.0
5846,Small Group,37058,37058,0,2018.csv,2018,100.0,0.0
5847,24 Frames,37045,34482,2563,2018.csv,2018,93.08138750168715,6.9186124983128625
5848,The Quiet One,37010,37010,0,2019.csv,2019,100.0,0.0
5849,Children of Paradise 2012 Re-release,36986,36986,0,2012.csv,2012,100.0,0.0
5850,Grey Gardens,36923,36923,0,2015.csv,2015,100.0,0.0
5851,Trust Fund,36885,36885,0,2016.csv,2016,100.0,0.0
5852,The Death of Dick Long,36856,36856,0,2019.csv,2019,100.0,0.0
5853,Three Christs,36723,36723,0,2020.csv,2020,100.0,0.0
5854,Sister Code,36676,36676,0,2015.csv,2015,100.0,0.0
5855,Mind Game,36613,36613,0,2018.csv,2018,100.0,0.0
5856,Bending the Arc,36586,21907,14679,2017.csv,2017,59.87809544634559,40.1219045536544
5857,Yoga Hosers,36585,0,36585,2016.csv,2016,0.0,100.0
5858,Hit So Hard,36576,34025,2551,2012.csv,2012,93.02548118985126,6.974518810148732
5859,Tread,36527,36527,0,2020.csv,2020,100.0,0.0
5860,For Those Who Don't Read Me,36506,36506,0,2018.csv,2018,100.0,0.0
5861,Cherry,36465,11362,25103,2010.csv,2010,31.158645276292336,68.84135472370765
5862,The Servant,36463,36463,0,2013.csv,2013,100.0,0.0
5863,Waiting for Anya,36404,0,36404,2020.csv,2020,0.0,100.0
5864,Unexpected,36402,23986,12416,2015.csv,2015,65.89198395692544,34.10801604307456
5865,How to Let Go of the World: and Love All the Things Climate Can't Change,36386,36386,0,2016.csv,2016,100.0,0.0
5866,Welcome to Leith,36380,36010,370,2015.csv,2015,98.98295766904893,1.017042330951072
5867,Mansome,36280,36280,0,2012.csv,2012,100.0,0.0
5868,Loro,36183,35613,570,2019.csv,2019,98.4246745709311,1.5753254290688998
5869,Loosies,36145,3519,32626,2012.csv,2012,9.735786415825148,90.26421358417484
5870,Touchy Feely,36128,36128,0,2013.csv,2013,100.0,0.0
5871,Le Corbeau,36089,36089,0,2018.csv,2018,100.0,0.0
5872,Brimstone & Glory,36036,32059,3977,2017.csv,2017,88.96381396381396,11.036186036186036
5873,"Kill Me, Deadly",36027,36027,0,2016.csv,2016,100.0,0.0
5874,Not Cool,36026,36026,0,2014.csv,2014,100.0,0.0
5875,Almost Friends,35842,1481,34361,2017.csv,2017,4.1320238825958375,95.86797611740417
5876,The House of Tomorrow,35821,35821,0,2018.csv,2018,100.0,0.0
5877,Bangkok Revenge,35784,35784,0,2012.csv,2012,100.0,0.0
5878,The Road Movie,35757,35757,0,2018.csv,2018,100.0,0.0
5879,Good Manners,35714,31177,4537,2018.csv,2018,87.29629837038696,12.703701629613038
5880,Paul Goodman Changed My Life,35671,35671,0,2011.csv,2011,100.0,0.0
5881,Far Out Isn't Far Enough: The Tomi Ungerer Story,35647,35647,0,2013.csv,2013,100.0,0.0
5882,M 2013 Re-release,35566,35566,0,2013.csv,2013,100.0,0.0
5883,Guy and Madeline on a Park Bench,35556,35556,0,2010.csv,2010,100.0,0.0
5884,Finders Keepers,35555,35555,0,2015.csv,2015,100.0,0.0
5885,PGS: Intuition Is Your Personal Guidance System,35423,35423,0,2018.csv,2018,100.0,0.0
5886,Kinyarwanda,35412,35412,0,2011.csv,2011,100.0,0.0
5887,Max and the Junkmen,35387,35387,0,2012.csv,2012,100.0,0.0
5888,Le Jour Se Leve,35321,35321,0,2014.csv,2014,100.0,0.0
5889,Growing Up Smith,35312,35312,0,2017.csv,2017,100.0,0.0
5890,The Decent One,35282,21327,13955,2014.csv,2014,60.447253557054594,39.55274644294541
5891,Underdogs,35271,35271,0,2013.csv,2013,100.0,0.0
5892,Rat Film,35195,35195,0,2017.csv,2017,100.0,0.0
5893,Ága,35178,35178,0,2019.csv,2019,100.0,0.0
5894,That Man from Rio,35144,35144,0,2014.csv,2014,100.0,0.0
5895,When Harry Tries to Marry,35100,35100,0,2011.csv,2011,100.0,0.0
5896,The Girl,35048,35048,0,2013.csv,2013,100.0,0.0
5897,Beneath the Harvest Sky,34768,34768,0,2014.csv,2014,100.0,0.0
5898,This Ain't No Mouse Music,34754,34754,0,2014.csv,2014,100.0,0.0
5899,Comic-Con Episode IV: A Fan's Hope,34665,34665,0,2012.csv,2012,100.0,0.0
5900,The Old Dark House,34649,25678,8971,2017.csv,2017,74.10892089237785,25.891079107622154
5901,Sophie and the Rising Sun,34630,34630,0,2017.csv,2017,100.0,0.0
5902,Le Trou,34588,34588,0,2017.csv,2017,100.0,0.0
5903,Orchestra of Exiles,34577,34577,0,2012.csv,2012,100.0,0.0
5904,Rakuen Tsuiho: Expelled from Paradise,34510,34510,0,2014.csv,2014,100.0,0.0
5905,Cosmos,34393,25856,8537,2015.csv,2015,75.17808856453348,24.82191143546652
5906,Pierrot le Fou 2015 Re-release,34371,34371,0,2015.csv,2015,100.0,0.0
5907,Holy Hell,34366,34366,0,2018.csv,2018,100.0,0.0
5908,Off the Rails,34249,34249,0,2016.csv,2016,100.0,0.0
5909,Rocks in My Pockets,34236,34236,0,2014.csv,2014,100.0,0.0
5910,Just Like a Woman,34206,11403,22803,2013.csv,2013,33.336256797053146,66.66374320294686
5911,Dave Made a Maze,34117,34117,0,2017.csv,2017,100.0,0.0
5912,Beautiful Darling,34096,34096,0,2011.csv,2011,100.0,0.0
5913,Kilo Two Bravo,34017,7891,26126,2015.csv,2015,23.19722491695329,76.80277508304671
5914,Bert Stern: Original Madman,34005,34005,0,2013.csv,2013,100.0,0.0
5915,RBG 2020 Re-release,34000,34000,0,2020.csv,2020,100.0,0.0
5916,Maui,33953,33953,0,2018.csv,2018,100.0,0.0
5917,Killer Unicorn,33901,33901,0,2019.csv,2019,100.0,0.0
5918,Moonlight Sonata: Deafness in Three Movements,33823,33823,0,2019.csv,2019,100.0,0.0
5919,It Felt Like Love,33817,33817,0,2014.csv,2014,100.0,0.0
5920,Closed Curtain,33735,28098,5637,2014.csv,2014,83.29035126722988,16.70964873277012
5921,Below Her Mouth,33673,0,33673,2017.csv,2017,0.0,100.0
5922,Shooting the Mafia,33547,10881,22666,2019.csv,2019,32.435091066265244,67.56490893373476
5923,Making the Boys,33443,33443,0,2011.csv,2011,100.0,0.0
5924,The Winding Stream,33420,33420,0,2015.csv,2015,100.0,0.0
5925,Final Girl,33411,0,33411,2015.csv,2015,0.0,100.0
5926,"Distant Voices, Still Lives 2018 Re-release",33301,5234,28067,2018.csv,2018,15.717245728356504,84.28275427164348
5927,Running from Crazy,33300,33300,0,2013.csv,2013,100.0,0.0
5928,Daddy Longlegs,33217,21766,11451,2010.csv,2010,65.52668814161423,34.47331185838577
5929,Wasted! The Story of Food Waste,33211,33211,0,2017.csv,2017,100.0,0.0
5930,Redoubt,33155,33155,0,2019.csv,2019,100.0,0.0
5931,Love & Taxes,33150,33150,0,2017.csv,2017,100.0,0.0
5932,American Teacher,33144,33144,0,2011.csv,2011,100.0,0.0
5933,Super Dark Times,33109,33109,0,2017.csv,2017,100.0,0.0
5934,Dislecksia: The Movie,33066,33066,0,2013.csv,2013,100.0,0.0
5935,Meet Monica Velour,33042,33042,0,2011.csv,2011,100.0,0.0
5936,Ahead of Time: The Extraordinary Journey of Ruth Gruber,33024,33024,0,2010.csv,2010,100.0,0.0
5937,Albatross,32992,0,32992,2011.csv,2011,0.0,100.0
5938,Being Charlie,32964,30400,2564,2016.csv,2016,92.22181774056547,7.778182259434535
5939,Spoken Word,32961,32961,0,2010.csv,2010,100.0,0.0
5940,The Intervention,32919,32919,0,2016.csv,2016,100.0,0.0
5941,No Home Movie,32757,32757,0,2016.csv,2016,100.0,0.0
5942,The Nun,32659,30245,2414,2018.csv,2018,92.60846933463976,7.391530665360238
5943,Sollers Point,32608,32608,0,2018.csv,2018,100.0,0.0
5944,The Day I Saw Your Heart 2012 Re-release,32567,3546,29021,2012.csv,2012,10.888322535081524,89.11167746491847
5945,Spettacolo,32494,32494,0,2017.csv,2017,100.0,0.0
5946,Boxing Gym,32476,32476,0,2010.csv,2010,100.0,0.0
5947,Rurouni Kenshin Part I: Origins 2016 Re-release,32445,32445,0,2016.csv,2016,100.0,0.0
5948,An Acceptable Loss,32427,32427,0,2019.csv,2019,100.0,0.0
5949,Brotherhood,32416,19722,12694,2010.csv,2010,60.840325765054295,39.159674234945705
5950,10E,32413,32413,0,2019.csv,2019,100.0,0.0
5951,Beetle Queen Conquers Tokyo,32308,32308,0,2010.csv,2010,100.0,0.0
5952,Living in Emergency,32208,32208,0,2010.csv,2010,100.0,0.0
5953,The Hero of Color City,32188,32188,0,2014.csv,2014,100.0,0.0
5954,Goodland,32140,32140,0,2018.csv,2018,100.0,0.0
5955,Desolation Center,32016,32016,0,2019.csv,2019,100.0,0.0
5956,"Rio, I Love You 2016 Re-release",31982,31982,0,2016.csv,2016,100.0,0.0
5957,Moynihan,31970,31970,0,2018.csv,2018,100.0,0.0
5958,District of Corruption,31954,31954,0,2012.csv,2012,100.0,0.0
5959,Amira & Sam,31849,31849,0,2015.csv,2015,100.0,0.0
5960,Paths of the Soul,31747,31747,0,2016.csv,2016,100.0,0.0
5961,180° South,31745,31745,0,2010.csv,2010,100.0,0.0
5962,At Berkeley,31736,31736,0,2013.csv,2013,100.0,0.0
5963,Aurora,31720,5677,26043,2011.csv,2011,17.89722572509458,82.10277427490541
5964,Gift,31588,31588,0,2019.csv,2019,100.0,0.0
5965,Signature Move,31551,31551,0,2017.csv,2017,100.0,0.0
5966,The Cat Rescuers,31540,31540,0,2019.csv,2019,100.0,0.0
5967,The Passionate Thief,31539,31539,0,2014.csv,2014,100.0,0.0
5968,Musical Chairs,31478,31478,0,2012.csv,2012,100.0,0.0
5969,Celine and Julie Go Boating,31452,31452,0,2012.csv,2012,100.0,0.0
5970,Beyond the Farthest Star,31433,31433,0,2013.csv,2013,100.0,0.0
5971,Here,31428,26743,4685,2012.csv,2012,85.09291078019601,14.907089219803996
5972,Sidemen: Long Road to Glory,31399,31399,0,2017.csv,2017,100.0,0.0
5973,Don Verdean,31309,31309,0,2015.csv,2015,100.0,0.0
5974,Buddy,31203,31203,0,2019.csv,2019,100.0,0.0
5975,"Hey, Boo: Harper Lee and 'To Kill a Mockingbird'",31135,31135,0,2011.csv,2011,100.0,0.0
5976,Small Town Murder Songs,31133,31133,0,2011.csv,2011,100.0,0.0
5977,7 Witches,31100,31100,0,2017.csv,2017,100.0,0.0
5978,White Irish Drinkers,31056,31056,0,2011.csv,2011,100.0,0.0
5979,Rent-A-Pal,31053,30901,152,2020.csv,2020,99.51051428203395,0.48948571796605805
5980,Poor Boy,31031,31031,0,2018.csv,2018,100.0,0.0
5981,"2 Autumns, 3 Winters",30985,5819,25166,2014.csv,2014,18.780054865257384,81.21994513474262
5982,The Seventh Fire,30977,30112,865,2016.csv,2016,97.20760564289634,2.7923943571036576
5983,Who Is Harry Nilsson (And Why Is Everybody Talkin' About Him?),30975,30975,0,2010.csv,2010,100.0,0.0
5984,Lamb,30844,14547,16297,2016.csv,2016,47.16314356114641,52.83685643885359
5985,Meet the Fokkens,30810,30810,0,2012.csv,2012,100.0,0.0
5986,Pasolini 2019 Re-release,30757,30757,0,2019.csv,2019,100.0,0.0
5987,Documented,30662,30662,0,2014.csv,2014,100.0,0.0
5988,Hide Away,30655,30655,0,2012.csv,2012,100.0,0.0
5989,The Chaperone,30514,0,30514,2011.csv,2011,0.0,100.0
5990,After Parkland,30444,30444,0,2020.csv,2020,100.0,0.0
5991,Los Reyes,30418,30418,0,2019.csv,2019,100.0,0.0
5992,Dealt,30414,30414,0,2017.csv,2017,100.0,0.0
5993,These Birds Walk,30408,30408,0,2013.csv,2013,100.0,0.0
5994,"Hare Krishna! The Mantra, the Movement and the Swami Who Started It 2017 Re-release",30380,19278,11102,2017.csv,2017,63.45622119815668,36.54377880184332
5995,Shanghai Red 2010 Re-release,30353,30353,0,2010.csv,2010,100.0,0.0
5996,Heavy Trip,30351,10153,20198,2018.csv,2018,33.45194557016244,66.54805442983756
5997,Happy Christmas,30312,30312,0,2014.csv,2014,100.0,0.0
5998,No Greater Love,30247,30247,0,2017.csv,2017,100.0,0.0
5999,Cold Water,30209,30209,0,2018.csv,2018,100.0,0.0
6000,Army of Shadows 2015 Re-release,30190,30190,0,2015.csv,2015,100.0,0.0
6001,Runoff,30186,30186,0,2015.csv,2015,100.0,0.0
6002,Paul Taylor: Creative Domain,30168,30168,0,2015.csv,2015,100.0,0.0
6003,Southern Baptist Sissies,30160,30160,0,2014.csv,2014,100.0,0.0
6004,In My Sleep,30158,30158,0,2010.csv,2010,100.0,0.0
6005,Lionel Richie at Glastonbury,30123,30123,0,2019.csv,2019,100.0,0.0
6006,Therapy for a Vampire 2016 Re-release,30115,30115,0,2016.csv,2016,100.0,0.0
6007,A Long Way Off,30104,30104,0,2014.csv,2014,100.0,0.0
6008,Manakamana,30029,30029,0,2014.csv,2014,100.0,0.0
6009,Cat Run,30000,30000,0,2011.csv,2011,100.0,0.0
6010,Evidence of a Haunting,29904,29904,0,2011.csv,2011,100.0,0.0
6011,Saint Misbehavin': The Wavy Gravy Movie,29893,29893,0,2010.csv,2010,100.0,0.0
6012,Lbs.,29866,29866,0,2010.csv,2010,100.0,0.0
6013,Brother 2012 Re-release,29864,29864,0,2012.csv,2012,100.0,0.0
6014,Long Shot: The Kevin Laue Story 2013 Re-release,29863,29863,0,2013.csv,2013,100.0,0.0
6015,A Fierce Green Fire: The Battle for A Living Planet,29817,29817,0,2013.csv,2013,100.0,0.0
6016,Uncertain,29736,29736,0,2017.csv,2017,100.0,0.0
6017,Multiple Sarcasms,29731,29731,0,2010.csv,2010,100.0,0.0
6018,Yellow Day,29656,29656,0,2014.csv,2014,100.0,0.0
6019,Memories of Underdevelopment 2018 Re-release,29647,29647,0,2018.csv,2018,100.0,0.0
6020,The Perfect Race,29644,29644,0,2019.csv,2019,100.0,0.0
6021,Dead Man's Burden,29634,29634,0,2013.csv,2013,100.0,0.0
6022,The Eyes of My Mother,29539,27099,2440,2016.csv,2016,91.73973391110057,8.26026608889942
6023,Little Fugitive 2013 Re-release,29505,29505,0,2013.csv,2013,100.0,0.0
6024,The Best Democracy Money Can Buy,29500,29500,0,2016.csv,2016,100.0,0.0
6025,The Dog Wedding,29495,29495,0,2016.csv,2016,100.0,0.0
6026,Olympic Dreams,29450,29450,0,2020.csv,2020,100.0,0.0
6027,Redemption Road,29384,29384,0,2011.csv,2011,100.0,0.0
6028,Cousin Jules,29337,29337,0,2013.csv,2013,100.0,0.0
6029,Charm City,29335,29335,0,2018.csv,2018,100.0,0.0
6030,The Topp Twins: Untouchable Girls 2011 Re-release,29316,29316,0,2011.csv,2011,100.0,0.0
6031,Lemon,29258,29258,0,2017.csv,2017,100.0,0.0
6032,The Ground Beneath My Feet,29251,29251,0,2019.csv,2019,100.0,0.0
6033,Time to Choose,29233,29233,0,2016.csv,2016,100.0,0.0
6034,Buffaloed,29118,29118,0,2020.csv,2020,100.0,0.0
6035,Fire in the Blood,28994,28994,0,2013.csv,2013,100.0,0.0
6036,Othello,28980,28980,0,2014.csv,2014,100.0,0.0
6037,Plush,28864,3080,25784,2013.csv,2013,10.670731707317072,89.32926829268293
6038,Two in the Wave,28808,28808,0,2010.csv,2010,100.0,0.0
6039,Batman & Robin 2019 Re-release,28793,28597,196,2019.csv,2019,99.31927899142153,0.680721008578474
6040,Rebels of the Neon God,28791,28791,0,2015.csv,2015,100.0,0.0
6041,Americons,28782,28782,0,2015.csv,2015,100.0,0.0
6042,Nénette,28699,18009,10690,2010.csv,2010,62.7513153768424,37.2486846231576
6043,Hitler's Children,28663,28663,0,2012.csv,2012,100.0,0.0
6044,Abe,28657,0,28657,2020.csv,2020,0.0,100.0
6045,The Transfiguration,28631,22091,6540,2017.csv,2017,77.1576263490622,22.842373650937795
6046,Garbo: El espía 2011 Re-release,28563,28563,0,2011.csv,2011,100.0,0.0
6047,Restoring Tomorrow,28556,28556,0,2018.csv,2018,100.0,0.0
6048,Stations of the Elevated,28516,28516,0,2014.csv,2014,100.0,0.0
6049,Carrie Pilby,28430,18957,9473,2017.csv,2017,66.679563841013,33.320436158986986
6050,"Rabin, the Last Day",28411,28411,0,2016.csv,2016,100.0,0.0
6051,The Load,28410,28410,0,2019.csv,2019,100.0,0.0
6052,Struck by Lightning,28378,28378,0,2013.csv,2013,100.0,0.0
6053,The Strange Ones,28374,0,28374,2017.csv,2017,0.0,100.0
6054,North Sea Texas 2012 Re-release,28307,28307,0,2012.csv,2012,100.0,0.0
6055,Arabian Nights: Volume 1 - The Restless One,28245,12260,15985,2015.csv,2015,43.405912550893966,56.594087449106034
6056,"Like Sunday, Like Rain",28208,28208,0,2015.csv,2015,100.0,0.0
6057,7 Chinese Brothers,28180,28180,0,2015.csv,2015,100.0,0.0
6058,The Ambassador,28102,28102,0,2012.csv,2012,100.0,0.0
6059,Bikes vs Cars,28072,28072,0,2015.csv,2015,100.0,0.0
6060,Sembene!,28059,28059,0,2015.csv,2015,100.0,0.0
6061,Take Me to the River,28041,28041,0,2016.csv,2016,100.0,0.0
6062,Least Among Saints,28026,28026,0,2012.csv,2012,100.0,0.0
6063,Quai des Orfèvres 2018 Re-release,28013,28013,0,2018.csv,2018,100.0,0.0
6064,The Amendment,27961,27961,0,2018.csv,2018,100.0,0.0
6065,Ribbons,27959,27959,0,2017.csv,2017,100.0,0.0
6066,El Norte 2019 Re-release,27920,27920,0,2019.csv,2019,100.0,0.0
6067,Radio Dreams,27836,27836,0,2017.csv,2017,100.0,0.0
6068,Bauhaus Spirit: 100 Years of Bauhaus,27768,17122,10646,2019.csv,2019,61.660904638432726,38.339095361567274
6069,Simon Killer,27740,27740,0,2013.csv,2013,100.0,0.0
6070,30 Years of Garbage: The Garbage Pail Kids Story,27739,27739,0,2017.csv,2017,100.0,0.0
6071,Senso,27723,27723,0,2018.csv,2018,100.0,0.0
6072,Broadway Idiot,27595,27595,0,2013.csv,2013,100.0,0.0
6073,The King and the Mockingbird 2014 Re-release,27513,27513,0,2014.csv,2014,100.0,0.0
6074,Kate Plays Christine,27364,25564,1800,2016.csv,2016,93.42201432539102,6.577985674608976
6075,Cane River 2020 Re-release,27317,27317,0,2020.csv,2020,100.0,0.0
6076,Unlocking the Cage,27284,27284,0,2016.csv,2016,100.0,0.0
6077,Tiger Eyes,27160,27160,0,2013.csv,2013,100.0,0.0
6078,Bronx Gothic,27151,27151,0,2017.csv,2017,100.0,0.0
6079,"Leaving Home, Coming Home: A Portrait of Robert Frank",27073,27073,0,2019.csv,2019,100.0,0.0
6080,Last Weekend,27053,27053,0,2014.csv,2014,100.0,0.0
6081,Clash,27052,27052,0,2011.csv,2011,100.0,0.0
6082,The Last Ride,27000,27000,0,2011.csv,2011,100.0,0.0
6083,Level Five,27000,27000,0,2014.csv,2014,100.0,0.0
6084,Mali Blues,26950,26950,0,2017.csv,2017,100.0,0.0
6085,A Monster with a Thousand Heads,26865,24852,2013,2016.csv,2016,92.5069793411502,7.4930206588498045
6086,"The Devil, Probably",26816,26816,0,2012.csv,2012,100.0,0.0
6087,Tap World,26747,26747,0,2015.csv,2015,100.0,0.0
6088,Peace Officer,26632,26632,0,2015.csv,2015,100.0,0.0
6089,"Pink Ribbons, Inc.",26608,26608,0,2012.csv,2012,100.0,0.0
6090,Wrestle,26597,26597,0,2019.csv,2019,100.0,0.0
6091,Milford Graves Full Mantis,26566,26566,0,2018.csv,2018,100.0,0.0
6092,José,26563,26563,0,2020.csv,2020,100.0,0.0
6093,Front Cover,26409,26409,0,2016.csv,2016,100.0,0.0
6094,At First Light,26338,3292,23046,2018.csv,2018,12.49905080112385,87.50094919887614
6095,Marlina the Murderer in Four Acts,26331,17788,8543,2018.csv,2018,67.55535300596254,32.44464699403745
6096,Donnybrook,26284,26284,0,2019.csv,2019,100.0,0.0
6097,October Country,26185,26185,0,2010.csv,2010,100.0,0.0
6098,The Misandrists,26123,26123,0,2018.csv,2018,100.0,0.0
6099,They Call us Monsters,26080,26080,0,2017.csv,2017,100.0,0.0
6100,Ridge Runners,26019,26019,0,2018.csv,2018,100.0,0.0
6101,Main Street,26011,2560,23451,2011.csv,2011,9.841989927338433,90.15801007266157
6102,Jet Trash 2018 Re-release,26002,26002,0,2018.csv,2018,100.0,0.0
6103,Black Mother,25919,18762,7157,2018.csv,2018,72.3870519695976,27.612948030402407
6104,Django,25916,25916,0,2012.csv,2012,100.0,0.0
6105,Women Like Us,25859,25859,0,2017.csv,2017,100.0,0.0
6106,Caesar and Otto's Summer Camp Massacre,25844,25844,0,2011.csv,2011,100.0,0.0
6107,Elena,25788,25788,0,2014.csv,2014,100.0,0.0
6108,Gurukulam,25651,25651,0,2016.csv,2016,100.0,0.0
6109,Passion Play,25603,3669,21934,2011.csv,2011,14.330351911885325,85.66964808811467
6110,The Exploding Girl,25572,25572,0,2010.csv,2010,100.0,0.0
6111,Banjo,25531,25531,0,2016.csv,2016,100.0,0.0
6112,Waiting for Forever,25517,25517,0,2011.csv,2011,100.0,0.0
6113,Unsubscribe,25488,25488,0,2020.csv,2020,100.0,0.0
6114,Christian Mingle,25480,25480,0,2014.csv,2014,100.0,0.0
6115,Kill Command,25427,0,25427,2016.csv,2016,0.0,100.0
6116,Nobody Walks,25342,25342,0,2012.csv,2012,100.0,0.0
6117,Rediscover Sautet,25314,25314,0,2015.csv,2015,100.0,0.0
6118,Disturbing the Peace,25287,25287,0,2016.csv,2016,100.0,0.0
6119,In Search of Fellini,25269,12772,12497,2017.csv,2017,50.54414499980213,49.45585500019787
6120,Death of the Virgin,25247,25247,0,2012.csv,2012,100.0,0.0
6121,The Worst Movie Ever!,25206,25206,0,2011.csv,2011,100.0,0.0
6122,Fresh,25115,25115,0,2010.csv,2010,100.0,0.0
6123,Vazante,25091,23884,1207,2018.csv,2018,95.18951018293413,4.81048981706588
6124,Disappearance at Clifton Hill,25084,25084,0,2020.csv,2020,100.0,0.0
6125,Bonnie & Clyde vs. Dracula,25027,25027,0,2011.csv,2011,100.0,0.0
6126,The Lucky Man,25015,25015,0,2017.csv,2017,100.0,0.0
6127,The Power of Few,25000,25000,0,2013.csv,2013,100.0,0.0
6128,Ugetsu,24959,11197,13762,2017.csv,2017,44.861572979686684,55.138427020313316
6129,R100,24956,24956,0,2015.csv,2015,100.0,0.0
6130,Naples '44,24863,24620,243,2017.csv,2017,99.02264408961106,0.9773559103889313
6131,An Elephant's Journey,24844,24844,0,2018.csv,2018,100.0,0.0
6132,Madaari,24822,0,24822,2016.csv,2016,0.0,100.0
6133,Light from Light,24808,24808,0,2019.csv,2019,100.0,0.0
6134,Marius/Fanny/César,24787,24787,0,2017.csv,2017,100.0,0.0
6135,Paradise 2017 Re-release,24749,24749,0,2017.csv,2017,100.0,0.0
6136,Strike,24743,15758,8985,2019.csv,2019,63.68669926847998,36.31330073152002
6137,Stage Mother,24736,0,24736,2020.csv,2020,0.0,100.0
6138,Cold Comes the Night,24732,16971,7761,2013.csv,2013,68.61960213488598,31.380397865114023
6139,The Day,24686,20984,3702,2012.csv,2012,85.00364579113668,14.996354208863325
6140,Hyenas,24672,24672,0,2019.csv,2019,100.0,0.0
6141,The Departure,24662,24662,0,2017.csv,2017,100.0,0.0
6142,Harvest,24657,24657,0,2011.csv,2011,100.0,0.0
6143,Knuckle,24655,2647,22008,2011.csv,2011,10.73615899411884,89.26384100588116
6144,Olvidados 2015 Re-release,24638,24638,0,2015.csv,2015,100.0,0.0
6145,Born to Fly: Elizabeth Streb vs. Gravity,24630,24630,0,2014.csv,2014,100.0,0.0
6146,Immigration Tango,24554,24554,0,2011.csv,2011,100.0,0.0
6147,The Aspern Papers,24554,9277,15277,2019.csv,2019,37.78203144090576,62.21796855909424
6148,After,24544,24544,0,2011.csv,2011,100.0,0.0
6149,Graceland,24529,24529,0,2013.csv,2013,100.0,0.0
6150,Too Late to Die Young,24487,16591,7896,2018.csv,2018,67.75431861804223,32.24568138195777
6151,Sudden Fear,24476,24476,0,2016.csv,2016,100.0,0.0
6152,Otter 501,24449,24449,0,2012.csv,2012,100.0,0.0
6153,The Trial of the Chicago 7,24357,0,24357,2020.csv,2020,0.0,100.0
6154,Last Days in the Desert,24352,0,24352,2016.csv,2016,0.0,100.0
6155,Honeymoon,24343,9318,15025,2014.csv,2014,38.27794437826069,61.722055621739315
6156,Le Petit Soldat,24296,24296,0,2013.csv,2013,100.0,0.0
6157,Jasmine,24248,24248,0,2017.csv,2017,100.0,0.0
6158,Heart of Africa,24139,24139,0,2020.csv,2020,100.0,0.0
6159,Radio Unnameable,24090,24090,0,2012.csv,2012,100.0,0.0
6160,Level Up,24083,1469,22614,2016.csv,2016,6.099738404683802,93.90026159531621
6161,Chasing Einstein,24057,24057,0,2019.csv,2019,100.0,0.0
6162,Ranchero,24036,24036,0,2011.csv,2011,100.0,0.0
6163,Steven Universe: The Movie,24012,0,24012,2019.csv,2019,0.0,100.0
6164,Beneath the Darkness,23998,0,23998,2012.csv,2012,0.0,100.0
6165,The Fiancé,23986,23986,0,2016.csv,2016,100.0,0.0
6166,Harry Dean Stanton: Partly Fiction,23959,23959,0,2013.csv,2013,100.0,0.0
6167,Almost Holy,23957,21142,2815,2016.csv,2016,88.24978085736946,11.750219142630547
6168,Simple Creature,23918,23918,0,2017.csv,2017,100.0,0.0
6169,Shut Up Little Man! An Audio Misadventure,23901,23901,0,2011.csv,2011,100.0,0.0
6170,Dear Mr. Watterson,23899,23899,0,2013.csv,2013,100.0,0.0
6171,Under The Wire,23897,3429,20468,2018.csv,2018,14.349081474662093,85.6509185253379
6172,Vincent N Roxxy,23896,0,23896,2017.csv,2017,0.0,100.0
6173,Behind the Burly Q,23889,23889,0,2010.csv,2010,100.0,0.0
6174,Emoticon ;),23881,23881,0,2014.csv,2014,100.0,0.0
6175,Happy Valley,23868,23868,0,2014.csv,2014,100.0,0.0
6176,Argentina,23864,14869,8995,2015.csv,2015,62.3072410325176,37.6927589674824
6177,Death House,23833,23833,0,2018.csv,2018,100.0,0.0
6178,Greenwich Village: Music That Defined a Generation,23701,23701,0,2013.csv,2013,100.0,0.0
6179,Raw Faith,23667,23667,0,2011.csv,2011,100.0,0.0
6180,Southbound,23665,23665,0,2016.csv,2016,100.0,0.0
6181,Good Kids,23627,0,23627,2016.csv,2016,0.0,100.0
6182,"Phoenix, Oregon",23613,23613,0,2020.csv,2020,100.0,0.0
6183,Lost Bohemia,23584,23584,0,2011.csv,2011,100.0,0.0
6184,"A Woman, a Part",23562,23562,0,2017.csv,2017,100.0,0.0
6185,An Evening with Beverly Luff Linn,23515,6701,16814,2018.csv,2018,28.496704231341695,71.5032957686583
6186,The Hill Chris Climbed: The Gridiron Heroes Story,23487,23487,0,2016.csv,2016,100.0,0.0
6187,Letter from Masanjia,23481,23481,0,2018.csv,2018,100.0,0.0
6188,Robert the Bruce,23425,0,23425,2019.csv,2019,0.0,100.0
6189,Believe Me,23419,23419,0,2014.csv,2014,100.0,0.0
6190,Can't Stand Losing You: Surviving the Police,23262,23262,0,2015.csv,2015,100.0,0.0
6191,For Ahkeem,23136,23136,0,2017.csv,2017,100.0,0.0
6192,The Judge,23127,22257,870,2018.csv,2018,96.23816318588663,3.7618368141133742
6193,Finding Oscar,23116,23116,0,2017.csv,2017,100.0,0.0
6194,The Iran Job,23115,23115,0,2012.csv,2012,100.0,0.0
6195,The Grace of Jake,23078,23078,0,2017.csv,2017,100.0,0.0
6196,Premature,23071,23071,0,2020.csv,2020,100.0,0.0
6197,Three Peaks,23069,16216,6853,2018.csv,2018,70.29346742381551,29.70653257618449
6198,History of Jazz: Oxygen for the Ears,23048,23048,0,2014.csv,2014,100.0,0.0
6199,Video Games: The Movie,23043,23043,0,2014.csv,2014,100.0,0.0
6200,Goat,23020,23020,0,2016.csv,2016,100.0,0.0
6201,Hellbound?,22887,22887,0,2012.csv,2012,100.0,0.0
6202,Mirza's Lady,22886,0,22886,2016.csv,2016,0.0,100.0
6203,Keyhole,22826,22826,0,2012.csv,2012,100.0,0.0
6204,The Long Day Closes,22765,22765,0,2012.csv,2012,100.0,0.0
6205,Carol Channing: Larger Than Life,22740,22740,0,2012.csv,2012,100.0,0.0
6206,The Revisionaries,22664,22664,0,2012.csv,2012,100.0,0.0
6207,Ode to Joy,22594,17303,5291,2019.csv,2019,76.58227848101265,23.417721518987342
6208,Trophy,22553,21439,1114,2017.csv,2017,95.06052409878953,4.939475901210482
6209,L'Innocente,22549,22549,0,2020.csv,2020,100.0,0.0
6210,The Other City,22539,22539,0,2010.csv,2010,100.0,0.0
6211,Anything,22537,19037,3500,2018.csv,2018,84.46998269512358,15.530017304876425
6212,The Black Dove,22517,22517,0,2016.csv,2016,100.0,0.0
6213,Casting By,22497,18164,4333,2013.csv,2013,80.73965417611237,19.26034582388763
6214,Middleground,22490,0,22490,2017.csv,2017,0.0,100.0
6215,Happy Tears,22464,22464,0,2010.csv,2010,100.0,0.0
6216,Incendiary,22457,22457,0,2011.csv,2011,100.0,0.0
6217,Realms,22443,147,22296,2017.csv,2017,0.6549926480417056,99.34500735195829
6218,Kamikaze 89,22440,22440,0,2016.csv,2016,100.0,0.0
6219,Be Here Now,22424,22424,0,2016.csv,2016,100.0,0.0
6220,Paradise Club,22381,22381,0,2017.csv,2017,100.0,0.0
6221,Girl Model,22369,21154,1215,2012.csv,2012,94.56837587733024,5.431624122669766
6222,Picture Me,22369,12008,10361,2010.csv,2010,53.68143412758729,46.31856587241271
6223,The Painting,22313,21008,1305,2012.csv,2012,94.15139156545511,5.848608434544884
6224,Tar,22307,22307,0,2020.csv,2020,100.0,0.0
6225,The Atomic Cafe,22293,22293,0,2018.csv,2018,100.0,0.0
6226,Metropolitan 2015 Re-release,22284,22284,0,2015.csv,2015,100.0,0.0
6227,Slow Learners,22272,22272,0,2015.csv,2015,100.0,0.0
6228,Generation Startup,22271,22271,0,2016.csv,2016,100.0,0.0
6229,Reparation,22267,22267,0,2016.csv,2016,100.0,0.0
6230,Winning Formula,22189,22189,0,2018.csv,2018,100.0,0.0
6231,All's Faire in Love,22180,22180,0,2011.csv,2011,100.0,0.0
6232,Princess Cut,22167,22167,0,2015.csv,2015,100.0,0.0
6233,Murder Eleven,22107,22107,0,2013.csv,2013,100.0,0.0
6234,The Garden of Eden,22083,22083,0,2010.csv,2010,100.0,0.0
6235,Losing Control,22081,22081,0,2012.csv,2012,100.0,0.0
6236,And Everything Is Going Fine,22080,22080,0,2010.csv,2010,100.0,0.0
6237,Four Adventures of Reinette and Mirabelle,22039,22039,0,2011.csv,2011,100.0,0.0
6238,Answers to Nothing,22029,22029,0,2011.csv,2011,100.0,0.0
6239,Pet,22003,8004,13999,2016.csv,2016,36.37685770122256,63.62314229877744
6240,The Sound of Silence,21994,20013,1981,2019.csv,2019,90.99299809038828,9.007001909611713
6241,The Passion of Joan of Arc,21877,21877,0,2017.csv,2017,100.0,0.0
6242,Deep Gold 3D,21868,12000,9868,2011.csv,2011,54.87470276202671,45.12529723797329
6243,The ABCs of Death,21832,21832,0,2013.csv,2013,100.0,0.0
6244,Animals 2015 Re-release,21821,21821,0,2015.csv,2015,100.0,0.0
6245,Viola,21818,21818,0,2013.csv,2013,100.0,0.0
6246,The Female Brain,21786,21786,0,2018.csv,2018,100.0,0.0
6247,Better Than Something: Jay Reatard,21697,21697,0,2012.csv,2012,100.0,0.0
6248,Dead Awake,21675,11528,10147,2017.csv,2017,53.18569780853518,46.814302191464826
6249,Évocateur: The Morton Downey Jr. Movie,21652,21652,0,2013.csv,2013,100.0,0.0
6250,Toe to Toe,21648,21648,0,2010.csv,2010,100.0,0.0
6251,Sedona,21638,21638,0,2012.csv,2012,100.0,0.0
6252,Blue Jay,21626,21626,0,2016.csv,2016,100.0,0.0
6253,Wicked Witches,21600,21600,0,2019.csv,2019,100.0,0.0
6254,Half the Picture,21589,21589,0,2018.csv,2018,100.0,0.0
6255,Waiting for Lightning,21577,21577,0,2012.csv,2012,100.0,0.0
6256,10 timer til Paradis,21561,16000,5561,2012.csv,2012,74.2080608506099,25.791939149390103
6257,Monogamy,21527,21527,0,2011.csv,2011,100.0,0.0
6258,Thank You for Your Service,21497,21497,0,2016.csv,2016,100.0,0.0
6259,Hagazussa,21487,13253,8234,2018.csv,2018,61.6791548378089,38.32084516219109
6260,Tyrel,21456,21456,0,2018.csv,2018,100.0,0.0
6261,Song Of Granite,21349,16182,5167,2017.csv,2017,75.79746123940231,24.202538760597687
6262,Tio Papi,21316,21316,0,2013.csv,2013,100.0,0.0
6263,Memphis,21286,21286,0,2014.csv,2014,100.0,0.0
6264,Resurrect Dead: The Mystery of the Toynbee Tiles,21242,21242,0,2011.csv,2011,100.0,0.0
6265,Already Tomorrow in Hong Kong,21206,21206,0,2016.csv,2016,100.0,0.0
6266,Ganja & Hess,21197,21197,0,2018.csv,2018,100.0,0.0
6267,The Pale Door,21166,0,21166,2020.csv,2020,0.0,100.0
6268,NightLights,21147,21147,0,2014.csv,2014,100.0,0.0
6269,God Knows Where I Am,21135,21135,0,2017.csv,2017,100.0,0.0
6270,The Happys,21108,21108,0,2018.csv,2018,100.0,0.0
6271,Massacre on Aisle 12,21106,21106,0,2017.csv,2017,100.0,0.0
6272,A Beginner's Guide to Snuff,21031,21031,0,2017.csv,2017,100.0,0.0
6273,The Sacrifice 2014 Re-release,20945,20945,0,2014.csv,2014,100.0,0.0
6274,Round of Your Life,20941,20941,0,2019.csv,2019,100.0,0.0
6275,Ava,20940,20940,0,2018.csv,2018,100.0,0.0
6276,Man Underground,20907,20907,0,2017.csv,2017,100.0,0.0
6277,Lekar Hum Deewana Dil,20874,20874,0,2014.csv,2014,100.0,0.0
6278,Cameraman: The Life and Work of Jack Cardiff,20840,20840,0,2011.csv,2011,100.0,0.0
6279,Time Changer 2016 Re-release,20797,20797,0,2016.csv,2016,100.0,0.0
6280,Did You Wonder Who Fired the Gun?,20765,20765,0,2018.csv,2018,100.0,0.0
6281,All These Sleepless Nights,20762,20762,0,2017.csv,2017,100.0,0.0
6282,For Ellen,20746,12396,8350,2012.csv,2012,59.75127735467078,40.248722645329224
6283,The Ghosts in Our Machine,20709,20709,0,2013.csv,2013,100.0,0.0
6284,The Great Flood,20694,20694,0,2014.csv,2014,100.0,0.0
6285,Freak Show,20657,19696,961,2018.csv,2018,95.34782398218522,4.652176017814784
6286,Douchebag,20615,20615,0,2010.csv,2010,100.0,0.0
6287,Our Nixon,20584,20584,0,2013.csv,2013,100.0,0.0
6288,Fidelio: Alice's Odyssey,20571,3580,16991,2015.csv,2015,17.403140343201596,82.5968596567984
6289,Coming Up Roses 2014 Re-release,20567,20567,0,2014.csv,2014,100.0,0.0
6290,Band of Robbers,20555,20555,0,2016.csv,2016,100.0,0.0
6291,The Work,20554,5853,14701,2017.csv,2017,28.476209010411598,71.52379098958839
6292,Ice Dragon: Legend of the Blue Daisies,20549,20549,0,2018.csv,2018,100.0,0.0
6293,This Last Lonely Place,20507,20507,0,2016.csv,2016,100.0,0.0
6294,Consumed,20476,20476,0,2015.csv,2015,100.0,0.0
6295,The Devil and Father Amorth,20449,20449,0,2018.csv,2018,100.0,0.0
6296,Boy Meets Girl,20441,20441,0,2015.csv,2015,100.0,0.0
6297,Burden,20437,18440,1997,2017.csv,2017,90.22850711944022,9.77149288055977
6298,Never,20431,20431,0,2016.csv,2016,100.0,0.0
6299,The Highest Pass,20386,20386,0,2012.csv,2012,100.0,0.0
6300,The All Americans,20324,20324,0,2019.csv,2019,100.0,0.0
6301,Koroshiya 1 2017 Re-release,20285,20285,0,2017.csv,2017,100.0,0.0
6302,The Korean,20279,20279,0,2010.csv,2010,100.0,0.0
6303,Double Take,20218,20218,0,2010.csv,2010,100.0,0.0
6304,Izzy Gets the F*ck Across Town,20208,20208,0,2018.csv,2018,100.0,0.0
6305,New World Order,20205,20205,0,2016.csv,2016,100.0,0.0
6306,Jesus Henry Christ,20183,20183,0,2012.csv,2012,100.0,0.0
6307,Shoah,20175,20175,0,2010.csv,2010,100.0,0.0
6308,Friends and Romans,20136,20136,0,2015.csv,2015,100.0,0.0
6309,How to Grow a Band,20135,20135,0,2012.csv,2012,100.0,0.0
6310,The Man from Outer Space,20102,20102,0,2017.csv,2017,100.0,0.0
6311,Love Me True,20100,20100,0,2016.csv,2016,100.0,0.0
6312,The Past is a Grotesque Animal,20056,20056,0,2014.csv,2014,100.0,0.0
6313,Apocalypsis,20052,20052,0,2018.csv,2018,100.0,0.0
6314,General Magic,20046,20046,0,2019.csv,2019,100.0,0.0
6315,The Gospel of Eureka,20039,20039,0,2019.csv,2019,100.0,0.0
6316,"No Pay, Nudity",20017,20017,0,2016.csv,2016,100.0,0.0
6317,Lore,20006,20006,0,2020.csv,2020,100.0,0.0
6318,Eight Hours Don't Make a Day,19987,19987,0,2018.csv,2018,100.0,0.0
6319,"One Sings, the Other Doesn't",19919,19919,0,2018.csv,2018,100.0,0.0
6320,Wedding Palace,19908,19908,0,2013.csv,2013,100.0,0.0
6321,Forbidden Games,19889,19889,0,2015.csv,2015,100.0,0.0
6322,Foster Boy,19873,19873,0,2020.csv,2020,100.0,0.0
6323,Active Measures,19862,19862,0,2018.csv,2018,100.0,0.0
6324,Heat and Dust 2017 Re-release,19856,19856,0,2017.csv,2017,100.0,0.0
6325,Wild Canaries,19777,19777,0,2015.csv,2015,100.0,0.0
6326,The Trial,19753,19753,0,2010.csv,2010,100.0,0.0
6327,The Romans,19705,19705,0,2016.csv,2016,100.0,0.0
6328,Trafficked,19698,19698,0,2017.csv,2017,100.0,0.0
6329,Misery Loves Comedy,19634,19634,0,2015.csv,2015,100.0,0.0
6330,Bad Milo,19613,19613,0,2013.csv,2013,100.0,0.0
6331,Art Bastard,19600,19600,0,2016.csv,2016,100.0,0.0
6332,Uzumasa Limelight,19597,19597,0,2014.csv,2014,100.0,0.0
6333,Zoology,19572,0,19572,2016.csv,2016,0.0,100.0
6334,Damascus Cover,19532,0,19532,2018.csv,2018,0.0,100.0
6335,Comet,19530,8623,10907,2014.csv,2014,44.152585765488986,55.84741423451101
6336,Hannah: Buddhism's Untold Journey,19526,396,19130,2016.csv,2016,2.028065143910683,97.97193485608932
6337,BOSTON: An American Running Story 2017 Re-release,19499,19499,0,2017.csv,2017,100.0,0.0
6338,Grassroots,19492,12356,7136,2012.csv,2012,63.39010876256926,36.609891237430745
6339,In Over My Head,19482,19482,0,2012.csv,2012,100.0,0.0
6340,Guardian Angel,19480,19480,0,2014.csv,2014,100.0,0.0
6341,A Picture of You,19480,19480,0,2014.csv,2014,100.0,0.0
6342,Whensday,19463,19463,0,2013.csv,2013,100.0,0.0
6343,Hunter Gatherer,19462,19462,0,2016.csv,2016,100.0,0.0
6344,Skateland,19411,19411,0,2011.csv,2011,100.0,0.0
6345,She Is the Ocean,19394,18828,566,2020.csv,2020,97.0815716200887,2.9184283799113127
6346,Mansfield 66/67,19390,17930,1460,2017.csv,2017,92.4703455389376,7.529654461062403
6347,Tchoupitoulas,19375,19375,0,2012.csv,2012,100.0,0.0
6348,Peter Brook: The Tightrope,19365,19365,0,2014.csv,2014,100.0,0.0
6349,Actress,19365,19365,0,2014.csv,2014,100.0,0.0
6350,Watchers of the Sky,19339,19339,0,2014.csv,2014,100.0,0.0
6351,Gabo: The Creation of Gabriel Garcia Marquez,19337,19337,0,2015.csv,2015,100.0,0.0
6352,Jackie & Ryan,19305,0,19305,2015.csv,2015,0.0,100.0
6353,Reuniting the Rubins,19288,13569,5719,2011.csv,2011,70.3494400663625,29.650559933637492
6354,Romeos,19248,1081,18167,2011.csv,2011,5.616167913549459,94.38383208645054
6355,Neshoba,19245,19245,0,2010.csv,2010,100.0,0.0
6356,Mandy 2020 Re-release,19169,19169,0,2020.csv,2020,100.0,0.0
6357,The People I've Slept With,19137,19137,0,2010.csv,2010,100.0,0.0
6358,Who We Are Now,19128,19128,0,2018.csv,2018,100.0,0.0
6359,That Most Important Thing: Love,19120,19120,0,2017.csv,2017,100.0,0.0
6360,Revelation: Dawn of Global Government,19107,19107,0,2016.csv,2016,100.0,0.0
6361,Make Believe,19085,19085,0,2011.csv,2011,100.0,0.0
6362,November,19084,19084,0,2018.csv,2018,100.0,0.0
6363,Search Engines,19033,19033,0,2016.csv,2016,100.0,0.0
6364,The Challenger,19003,19003,0,2015.csv,2015,100.0,0.0
6365,The Color Wheel,19001,19001,0,2012.csv,2012,100.0,0.0
6366,The Kill Team,18983,18983,0,2014.csv,2014,100.0,0.0
6367,Sophomore,18945,18945,0,2012.csv,2012,100.0,0.0
6368,Smash & Grab: The Story of the Pink Panthers,18938,18938,0,2013.csv,2013,100.0,0.0
6369,Ktown Cowboys,18863,18863,0,2016.csv,2016,100.0,0.0
6370,Nostalgia,18846,18846,0,2013.csv,2013,100.0,0.0
6371,Frank and Ava,18829,18829,0,2018.csv,2018,100.0,0.0
6372,Test,18823,18823,0,2014.csv,2014,100.0,0.0
6373,Scandalous: The True Story of the National Enquirer,18759,18759,0,2019.csv,2019,100.0,0.0
6374,The Sorcerer and the White Snake 2013 Re-release,18759,18759,0,2013.csv,2013,100.0,0.0
6375,Before Stonewall,18724,18724,0,2019.csv,2019,100.0,0.0
6376,Seoul Searching,18654,18654,0,2016.csv,2016,100.0,0.0
6377,Crime + Punishment,18644,18644,0,2018.csv,2018,100.0,0.0
6378,A Single Shot,18642,18642,0,2013.csv,2013,100.0,0.0
6379,Wish Me Away,18618,18618,0,2012.csv,2012,100.0,0.0
6380,The Return of Martin Guerre 2019 Re-release,18603,18603,0,2019.csv,2019,100.0,0.0
6381,The Pagan King: The Battle of Death,18598,0,18598,2018.csv,2018,0.0,100.0
6382,Bobbi Jene,18579,18579,0,2017.csv,2017,100.0,0.0
6383,La Camioneta: The Journey of One American School Bus,18558,18558,0,2013.csv,2013,100.0,0.0
6384,Let My People Go!,18529,18529,0,2013.csv,2013,100.0,0.0
6385,Allegiance to Broadway,18527,18527,0,2018.csv,2018,100.0,0.0
6386,Desolation,18490,18490,0,2018.csv,2018,100.0,0.0
6387,All the Rage,18489,18489,0,2017.csv,2017,100.0,0.0
6388,The Ghoul,18459,2032,16427,2017.csv,2017,11.00818029145674,88.99181970854326
6389,306 Hollywood,18399,18399,0,2018.csv,2018,100.0,0.0
6390,Shithouse,18370,18370,0,2020.csv,2020,100.0,0.0
6391,Oka!,18364,18364,0,2011.csv,2011,100.0,0.0
6392,"Phoenix, Oregon",18356,18356,0,2019.csv,2019,100.0,0.0
6393,"Intent to Destroy: Death, Denial & Depiction 2017 Re-release",18340,18340,0,2017.csv,2017,100.0,0.0
6394,The Channel,18319,18319,0,2016.csv,2016,100.0,0.0
6395,Four Bags Full,18297,18297,0,2013.csv,2013,100.0,0.0
6396,SHOT! The Psycho-Spiritual Mantra of Rock,18295,15157,3138,2017.csv,2017,82.84777261546871,17.152227384531294
6397,Off and Running,18262,18262,0,2010.csv,2010,100.0,0.0
6398,Tosca's Kiss,18236,18236,0,2014.csv,2014,100.0,0.0
6399,Torn,18202,18202,0,2013.csv,2013,100.0,0.0
6400,Marcelino Pan y Vino 2012 Re-release,18193,18193,0,2012.csv,2012,100.0,0.0
6401,Who is Dayani Cristal?,18190,18190,0,2014.csv,2014,100.0,0.0
6402,The Lion in Winter 2016 Re-release,18177,18177,0,2016.csv,2016,100.0,0.0
6403,Coming Through the Rye,18137,18137,0,2016.csv,2016,100.0,0.0
6404,King of Hearts,18130,17646,484,2018.csv,2018,97.3303916161059,2.669608383894098
6405,Peter and the Farm,18123,18123,0,2016.csv,2016,100.0,0.0
6406,Harry Benson: Shoot First,18092,18092,0,2016.csv,2016,100.0,0.0
6407,A Bit of Bad Luck,18089,18089,0,2016.csv,2016,100.0,0.0
6408,Total Recall 2012 Re-release,18081,18081,0,2012.csv,2012,100.0,0.0
6409,Holy Hell,18051,18051,0,2016.csv,2016,100.0,0.0
6410,On Tour with Pina Bausch,18016,18016,0,2014.csv,2014,100.0,0.0
6411,I Knew Her Well,18010,18010,0,2016.csv,2016,100.0,0.0
6412,Men Go to Battle,18006,18006,0,2016.csv,2016,100.0,0.0
6413,Battle for Brooklyn,18000,18000,0,2011.csv,2011,100.0,0.0
6414,Jamel Shabazz Street Photographer,17992,17992,0,2013.csv,2013,100.0,0.0
6415,Payback,17979,17979,0,2012.csv,2012,100.0,0.0
6416,Cook County,17977,17977,0,2011.csv,2011,100.0,0.0
6417,The Cranes Are Flying,17923,17923,0,2019.csv,2019,100.0,0.0
6418,Great Directors,17921,17921,0,2010.csv,2010,100.0,0.0
6419,Dealin' with Idiots,17909,17909,0,2013.csv,2013,100.0,0.0
6420,Li'l Quinquin,17868,7192,10676,2015.csv,2015,40.25072755764495,59.74927244235505
6421,The Thorn in the Heart,17849,7376,10473,2010.csv,2010,41.32444394643958,58.67555605356042
6422,The Last Shaman,17844,17844,0,2017.csv,2017,100.0,0.0
6423,Made in Hong Kong,17843,17843,0,2020.csv,2020,100.0,0.0
6424,David,17828,0,17828,2013.csv,2013,0.0,100.0
6425,Batman: Mask of the Phantasm 2018 Re-release,17813,17813,0,2018.csv,2018,100.0,0.0
6426,Escapes,17778,17778,0,2017.csv,2017,100.0,0.0
6427,Sacred,17740,17740,0,2017.csv,2017,100.0,0.0
6428,Little Birds,17739,17739,0,2012.csv,2012,100.0,0.0
6429,The Other One,17727,17727,0,2015.csv,2015,100.0,0.0
6430,Kelly & Cal,17702,17702,0,2014.csv,2014,100.0,0.0
6431,Bad Grandmas,17688,17688,0,2017.csv,2017,100.0,0.0
6432,The History of Future Folk,17646,17646,0,2013.csv,2013,100.0,0.0
6433,Kills On Wheels 2016 Re-release,17595,15898,1697,2017.csv,2017,90.35521454958794,9.64478545041205
6434,How He Fell in Love,17575,17575,0,2016.csv,2016,100.0,0.0
6435,The Chronicle of Anna Magdalena Bach,17527,17527,0,2018.csv,2018,100.0,0.0
6436,Streit's: Matzo and the American Dream,17506,17506,0,2016.csv,2016,100.0,0.0
6437,Butterfly Girl,17503,17503,0,2015.csv,2015,100.0,0.0
6438,Chained for Life,17431,17431,0,2019.csv,2019,100.0,0.0
6439,Pandora and the Flying Dutchman 2020 Re-release,17401,17401,0,2020.csv,2020,100.0,0.0
6440,The Law,17351,17351,0,2010.csv,2010,100.0,0.0
6441,"A Bread Factory, Part One/A Bread Factory, Part Two",17325,17325,0,2018.csv,2018,100.0,0.0
6442,Littlerock,17309,17309,0,2011.csv,2011,100.0,0.0
6443,The Homestretch,17306,17306,0,2014.csv,2014,100.0,0.0
6444,Archie's Final Project,17282,17282,0,2011.csv,2011,100.0,0.0
6445,Stand Clear of the Closing Doors,17282,17282,0,2014.csv,2014,100.0,0.0
6446,Revival,17252,17252,0,2018.csv,2018,100.0,0.0
6447,Landfill Harmonic,17205,17205,0,2016.csv,2016,100.0,0.0
6448,Food Evolution,17181,17181,0,2017.csv,2017,100.0,0.0
6449,Accident 2014 Re-release,17161,17161,0,2014.csv,2014,100.0,0.0
6450,Le Pont du Nord,17110,17110,0,2013.csv,2013,100.0,0.0
6451,Always Shine,17102,17102,0,2016.csv,2016,100.0,0.0
6452,On the Map,17099,17099,0,2016.csv,2016,100.0,0.0
6453,Grandmaster,17077,17077,0,2012.csv,2012,100.0,0.0
6454,The Understudy,17036,17036,0,2012.csv,2012,100.0,0.0
6455,Goodbye to All That,16986,16986,0,2014.csv,2014,100.0,0.0
6456,The Prophet's Son,16983,16983,0,2012.csv,2012,100.0,0.0
6457,Joseph Pulitzer: Voice of the People,16970,16970,0,2019.csv,2019,100.0,0.0
6458,Advocate,16942,16942,0,2020.csv,2020,100.0,0.0
6459,Carbon Nation,16901,16901,0,2010.csv,2010,100.0,0.0
6460,Return,16886,16124,762,2012.csv,2012,95.48738600023688,4.512613999763118
6461,Hank and Asha,16878,16878,0,2014.csv,2014,100.0,0.0
6462,Swim Team,16783,16783,0,2017.csv,2017,100.0,0.0
6463,Night Across the Street,16778,16778,0,2013.csv,2013,100.0,0.0
6464,Eva 2015 Re-release,16738,16738,0,2015.csv,2015,100.0,0.0
6465,Inventing Our Life: The Kibbutz Experiment,16734,16734,0,2012.csv,2012,100.0,0.0
6466,This Changes Everything,16692,16692,0,2015.csv,2015,100.0,0.0
6467,The World of Kanako 2015 Re-release,16627,16627,0,2015.csv,2015,100.0,0.0
6468,The Freebie,16613,16613,0,2010.csv,2010,100.0,0.0
6469,The Freedom to Marry,16611,16611,0,2017.csv,2017,100.0,0.0
6470,Who Took Johnny,16595,16595,0,2015.csv,2015,100.0,0.0
6471,Haikara-San: Here Comes Miss Modern,16572,16572,0,2018.csv,2018,100.0,0.0
6472,Life in a Walk,16557,16557,0,2015.csv,2015,100.0,0.0
6473,Brave New Jersey,16544,16544,0,2017.csv,2017,100.0,0.0
6474,33 & Beyond: The Royal Art of Freemasonry,16533,16533,0,2017.csv,2017,100.0,0.0
6475,Mission Control: The Unsung Heroes of Apollo,16405,16405,0,2017.csv,2017,100.0,0.0
6476,Magician: The Astonishing Life and Work of Orson Welles,16400,16400,0,2014.csv,2014,100.0,0.0
6477,Dying to Know: Ram Dass & Timothy Leary,16397,16397,0,2017.csv,2017,100.0,0.0
6478,Design Is One: The Vignellis,16386,16386,0,2013.csv,2013,100.0,0.0
6479,Centigrade,16263,16263,0,2020.csv,2020,100.0,0.0
6480,I Melt with You,16232,6361,9871,2011.csv,2011,39.18802365697388,60.81197634302612
6481,The Human Centipede III (Final Sequence),16184,16184,0,2015.csv,2015,100.0,0.0
6482,This is Our Land,16182,11567,4615,2017.csv,2017,71.48065752070202,28.519342479297986
6483,All the Queen's Horses,16172,16172,0,2017.csv,2017,100.0,0.0
6484,Detour,16172,16172,0,2018.csv,2018,100.0,0.0
6485,Virginia Minnesota,16118,16118,0,2019.csv,2019,100.0,0.0
6486,Levitated Mass,16086,16086,0,2014.csv,2014,100.0,0.0
6487,Straight Up,16080,16080,0,2020.csv,2020,100.0,0.0
6488,1920 London,16077,0,16077,2016.csv,2016,0.0,100.0
6489,Out of the Clear Blue Sky,16050,16050,0,2013.csv,2013,100.0,0.0
6490,Long Shot: The Kevin Laue Story,16011,16011,0,2012.csv,2012,100.0,0.0
6491,Planet of Snail,16002,13957,2045,2012.csv,2012,87.22034745656792,12.779652543432071
6492,Supercapitalist,16000,16000,0,2012.csv,2012,100.0,0.0
6493,Charged: The Eduardo Garcia Story,15920,15920,0,2017.csv,2017,100.0,0.0
6494,Can You Dig This,15909,15909,0,2015.csv,2015,100.0,0.0
6495,The Bay of Silence,15889,1941,13948,2020.csv,2020,12.215998489521052,87.78400151047894
6496,This Binary Universe,15875,15875,0,2012.csv,2012,100.0,0.0
6497,Starfish,15849,15849,0,2019.csv,2019,100.0,0.0
6498,A Reason,15792,15792,0,2015.csv,2015,100.0,0.0
6499,Defining Hope,15788,15788,0,2017.csv,2017,100.0,0.0
6500,Take Me Home,15760,15760,0,2012.csv,2012,100.0,0.0
6501,Full Moon in Paris,15726,15726,0,2015.csv,2015,100.0,0.0
6502,Trinity Seven The Movie 2: Heavens Library & Crimson Lord,15712,15712,0,2019.csv,2019,100.0,0.0
6503,Breakdance Academy,15628,15628,0,2010.csv,2010,100.0,0.0
6504,Dreams Rewired,15626,11843,3783,2015.csv,2015,75.79034941763727,24.20965058236273
6505,Out on Stage,15623,15623,0,2018.csv,2018,100.0,0.0
6506,The Competition 2019 Re-release,15622,15622,0,2019.csv,2019,100.0,0.0
6507,Basmati Blues,15605,0,15605,2017.csv,2017,0.0,100.0
6508,Five Nights in Maine,15587,15587,0,2016.csv,2016,100.0,0.0
6509,Bob le Flambeur,15586,15586,0,2018.csv,2018,100.0,0.0
6510,When You Read This Letter,15552,15552,0,2018.csv,2018,100.0,0.0
6511,Postcards from London,15548,5312,10236,2018.csv,2018,34.165165937741186,65.8348340622588
6512,Stuffed,15532,15532,0,2019.csv,2019,100.0,0.0
6513,Counter Column,15529,15529,0,2020.csv,2020,100.0,0.0
6514,Dreamkiller,15514,15514,0,2010.csv,2010,100.0,0.0
6515,Tom of Finland 2018 Re-release,15483,3314,12169,2018.csv,2018,21.404120648453144,78.59587935154686
6516,They Will Have to Kill Us First: Malian Music In Exile,15453,7516,7937,2015.csv,2015,48.637804956966285,51.36219504303372
6517,California Solo,15433,15433,0,2012.csv,2012,100.0,0.0
6518,Be Somebody,15395,15395,0,2016.csv,2016,100.0,0.0
6519,Between the Lines,15383,15383,0,2019.csv,2019,100.0,0.0
6520,Dumbstruck,15379,15379,0,2011.csv,2011,100.0,0.0
6521,The Adderall Diaries,15364,13191,2173,2016.csv,2016,85.85654777401717,14.143452225982816
6522,The President,15338,7578,7760,2016.csv,2016,49.40670230799322,50.59329769200678
6523,Narcissister Organ Player,15334,15334,0,2018.csv,2018,100.0,0.0
6524,Only the Young,15312,15312,0,2012.csv,2012,100.0,0.0
6525,Contemporary Color,15305,15305,0,2017.csv,2017,100.0,0.0
6526,American Deep State,15269,15269,0,2020.csv,2020,100.0,0.0
6527,Starcrossed,15263,15263,0,2016.csv,2016,100.0,0.0
6528,Arabian Nights: Volume 2 - The Desolate One,15245,6398,8847,2015.csv,2015,41.96785831420138,58.03214168579862
6529,People's Republic of Desire,15241,15241,0,2018.csv,2018,100.0,0.0
6530,The Samaritan,15220,2521,12699,2012.csv,2012,16.56373193166886,83.43626806833115
6531,Funan,15152,15152,0,2019.csv,2019,100.0,0.0
6532,The Olivia Experiment,15122,15122,0,2014.csv,2014,100.0,0.0
6533,Kung Fu Joe,15120,15120,0,2012.csv,2012,100.0,0.0
6534,Trade of Innocents,15091,15091,0,2012.csv,2012,100.0,0.0
6535,Rebels on Pointe,15088,15088,0,2017.csv,2017,100.0,0.0
6536,Cheatin',15077,15077,0,2015.csv,2015,100.0,0.0
6537,Barefoot,15071,15071,0,2014.csv,2014,100.0,0.0
6538,Caught in the Web,15033,1067,13966,2012.csv,2012,7.097718352956828,92.90228164704317
6539,I'm Not Jesus Mommy,15005,15005,0,2011.csv,2011,100.0,0.0
6540,The Tenant,15003,15003,0,2011.csv,2011,100.0,0.0
6541,Wrinkles the Clown,14938,14938,0,2019.csv,2019,100.0,0.0
6542,I Declare War,14928,14928,0,2013.csv,2013,100.0,0.0
6543,Trust Machine: The Story of Blockchain,14905,14905,0,2018.csv,2018,100.0,0.0
6544,La Maison de la radio,14905,8095,6810,2013.csv,2013,54.310634015431056,45.68936598456894
6545,ZZ Top: That Little Ol' Band from Texas,14879,14879,0,2019.csv,2019,100.0,0.0
6546,Horses of God 2014 Re-release,14817,14817,0,2014.csv,2014,100.0,0.0
6547,Vince Giordano: There's a Future in the Past,14807,14807,0,2017.csv,2017,100.0,0.0
6548,Kiss of the Damned,14752,14752,0,2013.csv,2013,100.0,0.0
6549,The Prey 2012 Re-release,14738,13959,779,2012.csv,2012,94.71434387298142,5.2856561270185916
6550,Sweet Virginia,14725,11753,2972,2017.csv,2017,79.81663837011884,20.183361629881155
6551,Gloria,14701,14701,0,2015.csv,2015,100.0,0.0
6552,30 Beats,14693,14693,0,2012.csv,2012,100.0,0.0
6553,Last Men in Aleppo,14637,14637,0,2017.csv,2017,100.0,0.0
6554,10 Days in a Madhouse,14616,14616,0,2015.csv,2015,100.0,0.0
6555,Unraveled,14615,14615,0,2012.csv,2012,100.0,0.0
6556,Buzzard,14591,14591,0,2015.csv,2015,100.0,0.0
6557,Tristana,14586,14586,0,2012.csv,2012,100.0,0.0
6558,Ferrante Fever,14518,11137,3381,2018.csv,2018,76.71166827386693,23.288331726133077
6559,The Wanderers 2016 Re-release,14492,14492,0,2016.csv,2016,100.0,0.0
6560,Antarctica: Ice and Sky 2017 Re-release,14475,14475,0,2017.csv,2017,100.0,0.0
6561,The Public Image is Rotten,14464,11293,3171,2018.csv,2018,78.07660398230088,21.923396017699115
6562,The Two Escobars,14457,14457,0,2010.csv,2010,100.0,0.0
6563,My Son 2019 Re-release,14450,14450,0,2019.csv,2019,100.0,0.0
6564,The Last Movie Star,14410,14410,0,2018.csv,2018,100.0,0.0
6565,The Unbelievers,14400,14400,0,2013.csv,2013,100.0,0.0
6566,The Uncondemned,14393,14393,0,2016.csv,2016,100.0,0.0
6567,Exhibition,14378,14344,34,2014.csv,2014,99.76352761162887,0.23647238837112253
6568,Justice Is Mind,14360,14360,0,2013.csv,2013,100.0,0.0
6569,Gone Doggy Gone,14354,14354,0,2015.csv,2015,100.0,0.0
6570,Peep World,14351,14351,0,2011.csv,2011,100.0,0.0
6571,Machines,14331,9710,4621,2017.csv,2017,67.75521596538971,32.244784034610284
6572,Never Stand Still,14272,14272,0,2012.csv,2012,100.0,0.0
6573,Combat Obscura,14242,14242,0,2019.csv,2019,100.0,0.0
6574,Saheb Biwi Aur Gangster,14231,14231,0,2011.csv,2011,100.0,0.0
6575,Brother Nature,14218,14218,0,2016.csv,2016,100.0,0.0
6576,A Perfect Man,14147,7117,7030,2013.csv,2013,50.30748568601117,49.69251431398883
6577,Newtown,14109,14109,0,2016.csv,2016,100.0,0.0
6578,We Won't Grow Old Together,14104,14104,0,2012.csv,2012,100.0,0.0
6579,"I Was at Home, But...",14078,14078,0,2020.csv,2020,100.0,0.0
6580,Shangri-La Suite,14073,14073,0,2016.csv,2016,100.0,0.0
6581,Gayby,14062,14062,0,2012.csv,2012,100.0,0.0
6582,6 Month Rule,14057,14057,0,2012.csv,2012,100.0,0.0
6583,Head Games,14056,14056,0,2012.csv,2012,100.0,0.0
6584,Ghetto Physics,14034,14034,0,2010.csv,2010,100.0,0.0
6585,Chasing the Blues,14030,14030,0,2018.csv,2018,100.0,0.0
6586,Il Futuro,14001,14001,0,2013.csv,2013,100.0,0.0
6587,Screwball,13967,13967,0,2019.csv,2019,100.0,0.0
6588,Yosemite,13931,13931,0,2016.csv,2016,100.0,0.0
6589,Weed the People,13926,13926,0,2018.csv,2018,100.0,0.0
6590,This Is Martin Bonner,13888,13888,0,2013.csv,2013,100.0,0.0
6591,Falling Away,13869,13869,0,2012.csv,2012,100.0,0.0
6592,Genesis,13856,6784,7072,2019.csv,2019,48.96073903002309,51.03926096997691
6593,Backcountry,13848,13848,0,2015.csv,2015,100.0,0.0
6594,Sympathy for Delicious,13826,13826,0,2011.csv,2011,100.0,0.0
6595,Stavisky...,13793,13793,0,2018.csv,2018,100.0,0.0
6596,The Pretty One,13769,13769,0,2014.csv,2014,100.0,0.0
6597,A Space Program,13739,13739,0,2016.csv,2016,100.0,0.0
6598,Dorfman in Love,13737,13737,0,2013.csv,2013,100.0,0.0
6599,Don McKay,13722,13722,0,2010.csv,2010,100.0,0.0
6600,Time to Die,13707,13707,0,2017.csv,2017,100.0,0.0
6601,Daisies,13692,13692,0,2012.csv,2012,100.0,0.0
6602,This One's for the Ladies,13688,13688,0,2019.csv,2019,100.0,0.0
6603,The Law in These Parts,13683,13683,0,2012.csv,2012,100.0,0.0
6604,Tikkun,13671,13671,0,2016.csv,2016,100.0,0.0
6605,Red Trees,13666,13666,0,2017.csv,2017,100.0,0.0
6606,Fifi Howls from Happiness,13614,13614,0,2014.csv,2014,100.0,0.0
6607,When the Iron Bird Flies: Tibetan Buddhism Arrives in the West,13598,13598,0,2012.csv,2012,100.0,0.0
6608,Stray Dogs,13573,10433,3140,2014.csv,2014,76.86583658734251,23.134163412657482
6609,Eli,13547,13547,0,2015.csv,2015,100.0,0.0
6610,Dysfunctional Friends,13546,13546,0,2012.csv,2012,100.0,0.0
6611,Paper Man,13514,13514,0,2010.csv,2010,100.0,0.0
6612,Handsome Harry,13500,13500,0,2010.csv,2010,100.0,0.0
6613,Shadowman,13498,13498,0,2017.csv,2017,100.0,0.0
6614,Spices of Liberty,13463,13463,0,2016.csv,2016,100.0,0.0
6615,War of the Worlds: Goliath,13385,13385,0,2014.csv,2014,100.0,0.0
6616,Solaris 2017 Re-release,13352,0,13352,2017.csv,2017,0.0,100.0
6617,Violet Tendencies,13304,13304,0,2010.csv,2010,100.0,0.0
6618,Rapid Response,13294,13294,0,2019.csv,2019,100.0,0.0
6619,Late Spring,13254,13254,0,2016.csv,2016,100.0,0.0
6620,Days and Nights,13243,13243,0,2014.csv,2014,100.0,0.0
6621,Our Blood is Wine,13210,13210,0,2018.csv,2018,100.0,0.0
6622,"Intent to Destroy: Death, Denial & Depiction",13194,13194,0,2017.csv,2017,100.0,0.0
6623,Sol LeWitt,13146,13146,0,2014.csv,2014,100.0,0.0
6624,The Pleasures of Being Out of Step,13137,13137,0,2014.csv,2014,100.0,0.0
6625,The Trouble with Bliss,13093,13093,0,2012.csv,2012,100.0,0.0
6626,Under the Boardwalk: The Monopoly Story,13080,13080,0,2011.csv,2011,100.0,0.0
6627,Nothing But a Man,13063,13063,0,2012.csv,2012,100.0,0.0
6628,"How Much Does Your Building Weigh, Mr Foster? 2012 Re-release",13013,13013,0,2012.csv,2012,100.0,0.0
6629,Jim,13000,13000,0,2010.csv,2010,100.0,0.0
6630,Bloodworth,12971,12971,0,2011.csv,2011,100.0,0.0
6631,Like Me,12965,12965,0,2018.csv,2018,100.0,0.0
6632,Duet for Cannibals 2019 re-release,12962,12962,0,2019.csv,2019,100.0,0.0
6633,K2: Siren of the Himalayas,12959,12959,0,2014.csv,2014,100.0,0.0
6634,The Last Rampage,12944,6294,6650,2017.csv,2017,48.62484548825711,51.37515451174289
6635,A Green Story,12901,12901,0,2013.csv,2013,100.0,0.0
6636,Taipei Story,12897,12897,0,2017.csv,2017,100.0,0.0
6637,Permanent,12847,12847,0,2017.csv,2017,100.0,0.0
6638,The Taqwacores,12839,11445,1394,2010.csv,2010,89.14245657761508,10.857543422384921
6639,Junction 48,12795,12795,0,2017.csv,2017,100.0,0.0
6640,Yakuza Apocalypse,12756,12756,0,2015.csv,2015,100.0,0.0
6641,Virginia,12728,12728,0,2012.csv,2012,100.0,0.0
6642,Breakdance Academy 2013 Re-release,12708,12708,0,2013.csv,2013,100.0,0.0
6643,Concerning Violence,12680,12680,0,2014.csv,2014,100.0,0.0
6644,Heal,12668,12668,0,2017.csv,2017,100.0,0.0
6645,Bhopal: A Prayer for Rain,12628,12628,0,2014.csv,2014,100.0,0.0
6646,Kangaroo,12626,4547,8079,2018.csv,2018,36.01298907017266,63.987010929827335
6647,American Socialist: The Life and Times of Eugene Victor Debs,12609,12609,0,2018.csv,2018,100.0,0.0
6648,Boy Meets Girl,12589,12589,0,2014.csv,2014,100.0,0.0
6649,Husbands in Goa,12588,10135,2453,2012.csv,2012,80.51318716237687,19.486812837623134
6650,Of Fathers and Sons,12579,12579,0,2018.csv,2018,100.0,0.0
6651,Around June,12578,12578,0,2012.csv,2012,100.0,0.0
6652,My Art,12554,12554,0,2018.csv,2018,100.0,0.0
6653,Off Season,12544,12544,0,2019.csv,2019,100.0,0.0
6654,City of Women,12516,12516,0,2016.csv,2016,100.0,0.0
6655,Seven Beauties,12408,12408,0,2017.csv,2017,100.0,0.0
6656,Killer Raccoons! 2! Dark Christmas in the Dark!,12382,12382,0,2020.csv,2020,100.0,0.0
6657,American Chaos,12368,12368,0,2018.csv,2018,100.0,0.0
6658,America the Beautiful 2: The Thin Commandments,12366,12366,0,2011.csv,2011,100.0,0.0
6659,Rebirth,12358,12358,0,2011.csv,2011,100.0,0.0
6660,L'héritage de la chouette,12316,12316,0,2018.csv,2018,100.0,0.0
6661,4 Days in France,12273,12273,0,2017.csv,2017,100.0,0.0
6662,The Armor of Light,12267,12267,0,2015.csv,2015,100.0,0.0
6663,Wa-shoku Dream: Beyond Sushi,12240,12240,0,2015.csv,2015,100.0,0.0
6664,The Living Wake,12232,12232,0,2010.csv,2010,100.0,0.0
6665,Bricked,12201,12201,0,2019.csv,2019,100.0,0.0
6666,Elstree 1976,12173,12173,0,2016.csv,2016,100.0,0.0
6667,Destiny,12156,12156,0,2016.csv,2016,100.0,0.0
6668,Touch the Wall,12156,12156,0,2014.csv,2014,100.0,0.0
6669,Greetings from Tim Buckley,12155,11157,998,2013.csv,2013,91.78938708350472,8.210612916495268
6670,Back Door Channels: The Price of Peace,12139,12139,0,2011.csv,2011,100.0,0.0
6671,In No Great Hurry: 13 Lessons in Life with Saul Leiter,12133,12133,0,2014.csv,2014,100.0,0.0
6672,The Most Unknown,12119,12119,0,2018.csv,2018,100.0,0.0
6673,Call Me Kuchu,12110,9124,2986,2012.csv,2012,75.34269199009084,24.657308009909165
6674,Zen for Nothing,12107,12107,0,2019.csv,2019,100.0,0.0
6675,Hot Water,12101,12101,0,2016.csv,2016,100.0,0.0
6676,The Kids Grow Up,12095,12095,0,2010.csv,2010,100.0,0.0
6677,A Murder in the Park,12088,12088,0,2015.csv,2015,100.0,0.0
6678,When Two Worlds Collide,12080,12080,0,2016.csv,2016,100.0,0.0
6679,Little England 2015 Re-release,12077,12077,0,2015.csv,2015,100.0,0.0
6680,Imprisoned,12050,12050,0,2019.csv,2019,100.0,0.0
6681,Quartet,12042,12042,0,2019.csv,2019,100.0,0.0
6682,Lost Angels: Skid Row Is My Home,12025,12025,0,2012.csv,2012,100.0,0.0
6683,Queen Margot 2014 Re-release,12005,12005,0,2014.csv,2014,100.0,0.0
6684,Autumn Sonata 2017 Re-release,11959,0,11959,2017.csv,2017,0.0,100.0
6685,The Strange Little Cat,11956,5885,6071,2014.csv,2014,49.22214787554366,50.77785212445634
6686,The Last Race,11947,11947,0,2018.csv,2018,100.0,0.0
6687,Frank Serpico,11925,11925,0,2017.csv,2017,100.0,0.0
6688,"Cassandro, The Exotico!",11897,11897,0,2019.csv,2019,100.0,0.0
6689,Hollywould,11888,11888,0,2019.csv,2019,100.0,0.0
6690,Revenge of the Mekons,11861,11861,0,2014.csv,2014,100.0,0.0
6691,Les Parents Terribles,11818,11818,0,2018.csv,2018,100.0,0.0
6692,Emptying the Skies,11811,11811,0,2015.csv,2015,100.0,0.0
6693,The Dry Land,11777,11777,0,2010.csv,2010,100.0,0.0
6694,Summer '03,11746,11746,0,2018.csv,2018,100.0,0.0
6695,Rid of Me,11740,11740,0,2011.csv,2011,100.0,0.0
6696,Lucha Mexico,11722,11722,0,2016.csv,2016,100.0,0.0
6697,White Wedding 2010 Re-release,11710,11710,0,2010.csv,2010,100.0,0.0
6698,The Grizzlies,11650,11650,0,2020.csv,2020,100.0,0.0
6699,36 Saints,11640,11640,0,2013.csv,2013,100.0,0.0
6700,The Tribes of Palos Verdes,11603,11603,0,2017.csv,2017,100.0,0.0
6701,11 Flowers,11599,9213,2386,2012.csv,2012,79.429261143202,20.570738856798
6702,Around India with a Movie Camera,11568,10389,1179,2018.csv,2018,89.80809128630706,10.191908713692946
6703,The Preppie Connection,11558,11558,0,2016.csv,2016,100.0,0.0
6704,River of Grass,11553,11553,0,2016.csv,2016,100.0,0.0
6705,The Ruins of Lifta,11548,11548,0,2016.csv,2016,100.0,0.0
6706,Ultrasuede: In Search of Halston,11539,11539,0,2012.csv,2012,100.0,0.0
6707,After the Cup: Sons of Sakhnin United,11538,11538,0,2010.csv,2010,100.0,0.0
6708,Elektra Luxx,11514,11514,0,2011.csv,2011,100.0,0.0
6709,The Final Member,11428,11428,0,2014.csv,2014,100.0,0.0
6710,The Great Invisible,11428,11428,0,2014.csv,2014,100.0,0.0
6711,Beside Bowie: The Mick Ronson Story,11400,11400,0,2017.csv,2017,100.0,0.0
6712,Rendezvous in July,11321,11321,0,2018.csv,2018,100.0,0.0
6713,Powerbomb,11319,11319,0,2020.csv,2020,100.0,0.0
6714,Draupadi Unleashed,11317,11317,0,2020.csv,2020,100.0,0.0
6715,Viktoria,11314,11314,0,2016.csv,2016,100.0,0.0
6716,Saigon Bodyguards,11314,11314,0,2017.csv,2017,100.0,0.0
6717,Lost in America,11301,11301,0,2020.csv,2020,100.0,0.0
6718,Dishkiyaoon,11288,11288,0,2014.csv,2014,100.0,0.0
6719,Theo Who Lived,11271,11271,0,2016.csv,2016,100.0,0.0
6720,Daylight's End,11257,0,11257,2016.csv,2016,0.0,100.0
6721,Bullitt County,11257,11257,0,2018.csv,2018,100.0,0.0
6722,In Like Flynn,11255,11255,0,2019.csv,2019,100.0,0.0
6723,Hacker,11239,11239,0,2016.csv,2016,100.0,0.0
6724,The Pathological Optimist,11222,11222,0,2017.csv,2017,100.0,0.0
6725,Children of Invention,11183,11183,0,2010.csv,2010,100.0,0.0
6726,Made Me Do It,11151,11151,0,2019.csv,2019,100.0,0.0
6727,"Now, Forager",11146,11146,0,2012.csv,2012,100.0,0.0
6728,InSight,11100,11100,0,2011.csv,2011,100.0,0.0
6729,The Black Book of Father Dinis,11057,0,11057,2018.csv,2018,0.0,100.0
6730,Edward II 2018 Re-release,11055,4826,6229,2018.csv,2018,43.654454997738576,56.345545002261424
6731,The Challenge,11043,11043,0,2017.csv,2017,100.0,0.0
6732,The Woman with the 5 Elephants 2011 Re-release,11026,11026,0,2011.csv,2011,100.0,0.0
6733,PAY 2 PLAY: Democracy's High Stakes,11021,11021,0,2014.csv,2014,100.0,0.0
6734,Midget Zombie Takeover,11006,11006,0,2013.csv,2013,100.0,0.0
6735,Christina,11000,11000,0,2010.csv,2010,100.0,0.0
6736,Suburban Birds,10997,10997,0,2019.csv,2019,100.0,0.0
6737,16 Bars,10985,10985,0,2019.csv,2019,100.0,0.0
6738,Just Before I Go,10970,10970,0,2015.csv,2015,100.0,0.0
6739,Digging Up the Marrow,10969,10969,0,2015.csv,2015,100.0,0.0
6740,Very Good Girls,10963,6940,4023,2014.csv,2014,63.30384018972909,36.69615981027091
6741,Wallander: Hämnden 2012 Re-release,10960,10960,0,2012.csv,2012,100.0,0.0
6742,Sarah Palin: You Betcha!,10935,10935,0,2011.csv,2011,100.0,0.0
6743,If the Dancer Dances,10912,10912,0,2019.csv,2019,100.0,0.0
6744,As It Is in Heaven,10850,10850,0,2014.csv,2014,100.0,0.0
6745,What Happened Last Night,10844,10844,0,2016.csv,2016,100.0,0.0
6746,The Forecaster,10824,10172,652,2015.csv,2015,93.97634885439764,6.023651145602365
6747,Bleeding Heart,10815,0,10815,2015.csv,2015,0.0,100.0
6748,Terkel in Trouble 2010 Re-release,10783,10783,0,2010.csv,2010,100.0,0.0
6749,The Man Who Shook the Hand of Vicente Fernandez,10782,10782,0,2012.csv,2012,100.0,0.0
6750,Vision Portraits,10771,10771,0,2019.csv,2019,100.0,0.0
6751,Mala Mala,10761,10761,0,2015.csv,2015,100.0,0.0
6752,A Resurrection,10730,10730,0,2013.csv,2013,100.0,0.0
6753,Hollow in the Land,10688,0,10688,2017.csv,2017,0.0,100.0
6754,You Go to My Head,10682,10682,0,2020.csv,2020,100.0,0.0
6755,Made in Cleveland,10681,10681,0,2013.csv,2013,100.0,0.0
6756,Frankie & Alice,10670,10670,0,2010.csv,2010,100.0,0.0
6757,National Bird,10656,10656,0,2016.csv,2016,100.0,0.0
6758,American Meat,10650,10650,0,2013.csv,2013,100.0,0.0
6759,Caucus,10645,10645,0,2013.csv,2013,100.0,0.0
6760,Lovesong,10626,10626,0,2017.csv,2017,100.0,0.0
6761,Intuitions,10606,10606,0,2019.csv,2019,100.0,0.0
6762,Marriage Italian Style 2011 Re-release,10600,10600,0,2011.csv,2011,100.0,0.0
6763,Inside the Mind of Leonardo,10600,10600,0,2014.csv,2014,100.0,0.0
6764,China Heavyweight,10550,10550,0,2012.csv,2012,100.0,0.0
6765,I'll Take Your Dead,10523,10523,0,2019.csv,2019,100.0,0.0
6766,Waiting for Armageddon,10501,10501,0,2010.csv,2010,100.0,0.0
6767,Clarence,10495,10495,0,2017.csv,2017,100.0,0.0
6768,Santa Mesa,10490,10490,0,2012.csv,2012,100.0,0.0
6769,Neon Flesh 2012 Re-release,10483,0,10483,2012.csv,2012,0.0,100.0
6770,"Norte, the End of History",10457,10457,0,2014.csv,2014,100.0,0.0
6771,Evil Intent,10454,10454,0,2013.csv,2013,100.0,0.0
6772,Class Rank,10452,10452,0,2018.csv,2018,100.0,0.0
6773,Mama Africa 2018 Re-release,10430,10430,0,2018.csv,2018,100.0,0.0
6774,The Advocates,10402,10402,0,2018.csv,2018,100.0,0.0
6775,Shanghai Calling,10400,10400,0,2013.csv,2013,100.0,0.0
6776,Elemental,10358,10358,0,2013.csv,2013,100.0,0.0
6777,Zero Bridge,10357,10357,0,2011.csv,2011,100.0,0.0
6778,SK1 2016 Re-release,10330,10330,0,2016.csv,2016,100.0,0.0
6779,Painted Woman,10298,10298,0,2017.csv,2017,100.0,0.0
6780,Shepard & Dark,10278,10278,0,2013.csv,2013,100.0,0.0
6781,Moebius,10254,2340,7914,2014.csv,2014,22.820362785254535,77.17963721474547
6782,Coded Bias,10236,10236,0,2020.csv,2020,100.0,0.0
6783,The Endless Summer,10233,10233,0,2014.csv,2014,100.0,0.0
6784,Amelia 2.0,10233,10233,0,2017.csv,2017,100.0,0.0
6785,Approaching the Unknown,10232,10232,0,2016.csv,2016,100.0,0.0
6786,Tip Top,10201,6050,4151,2013.csv,2013,59.30791098911872,40.69208901088129
6787,When Lambs Become Lions,10197,9337,860,2019.csv,2019,91.56614690595273,8.433853094047269
6788,Prince of the Himalayas,10190,10190,0,2011.csv,2011,100.0,0.0
6789,Miss Minoes 2011 Re-release,10189,10189,0,2011.csv,2011,100.0,0.0
6790,A Bird of the Air,10152,10152,0,2011.csv,2011,100.0,0.0
6791,Beta Test,10104,10104,0,2016.csv,2016,100.0,0.0
6792,Putin's Kiss,10082,10082,0,2012.csv,2012,100.0,0.0
6793,Pawn Shop Chronicles,10080,8088,1992,2013.csv,2013,80.23809523809524,19.761904761904763
6794,Before I Disappear,10078,10078,0,2014.csv,2014,100.0,0.0
6795,Little Accidents,10071,10071,0,2015.csv,2015,100.0,0.0
6796,Informant,10068,10068,0,2013.csv,2013,100.0,0.0
6797,The Sunshine Makers,10042,10042,0,2017.csv,2017,100.0,0.0
6798,Circle,10024,10024,0,2010.csv,2010,100.0,0.0
6799,The Life and Mind of Mark DeFriest,10021,10021,0,2015.csv,2015,100.0,0.0
6800,Guest Artist,10017,10017,0,2020.csv,2020,100.0,0.0
6801,Arjun: The Warrior Prince,10017,10017,0,2012.csv,2012,100.0,0.0
6802,The Do-Deca-Pentathlon,10000,10000,0,2012.csv,2012,100.0,0.0
6803,"Hugh Hefner: Playboy, Activist and Rebel",10000,10000,0,2010.csv,2010,100.0,0.0
6804,Tere Bin Laden: Dead Or Alive,9995,0,9995,2016.csv,2016,0.0,100.0
6805,Foosballers,9966,9966,0,2020.csv,2020,100.0,0.0
6806,Made in France,9956,9956,0,2016.csv,2016,100.0,0.0
6807,Olivia,9934,9934,0,2019.csv,2019,100.0,0.0
6808,Streetwise,9904,9904,0,2019.csv,2019,100.0,0.0
6809,52 Tuesdays,9844,0,9844,2015.csv,2015,0.0,100.0
6810,Kabbalah Me,9816,9816,0,2014.csv,2014,100.0,0.0
6811,Down Terrace,9812,9812,0,2010.csv,2010,100.0,0.0
6812,Birth of the Living Dead,9802,9802,0,2013.csv,2013,100.0,0.0
6813,Pelle the Conqueror 2017 Re-release,9757,9757,0,2017.csv,2017,100.0,0.0
6814,"If You Don't, I Will",9719,9719,0,2014.csv,2014,100.0,0.0
6815,Antoine & Antoinette,9704,9704,0,2013.csv,2013,100.0,0.0
6816,Brutal Beauty: Tales of the Rose City Rollers,9677,9677,0,2010.csv,2010,100.0,0.0
6817,The Quest of Alain Ducasse,9627,9627,0,2018.csv,2018,100.0,0.0
6818,The Spanish Prisoner 2019 Re-release,9589,9589,0,2019.csv,2019,100.0,0.0
6819,Vito Bonafacci,9570,9570,0,2011.csv,2011,100.0,0.0
6820,Chosen,9536,9283,253,2016.csv,2016,97.34689597315436,2.6531040268456376
6821,The Lost Arcade,9522,9522,0,2016.csv,2016,100.0,0.0
6822,Strangers on the Earth,9518,9518,0,2018.csv,2018,100.0,0.0
6823,Living Proof,9512,9512,0,2017.csv,2017,100.0,0.0
6824,In the House of Flies,9480,9480,0,2014.csv,2014,100.0,0.0
6825,Northern Lights,9453,9453,0,2013.csv,2013,100.0,0.0
6826,If I Were You,9432,9432,0,2013.csv,2013,100.0,0.0
6827,Zero Charisma,9417,9417,0,2013.csv,2013,100.0,0.0
6828,"One Cut, One Life",9406,9406,0,2015.csv,2015,100.0,0.0
6829,Miss Kiet's Children 2017 Re-release,9384,9384,0,2017.csv,2017,100.0,0.0
6830,The Tree of Wooden Clogs,9367,0,9367,2016.csv,2016,0.0,100.0
6831,Radio Free Albemuth,9365,9365,0,2014.csv,2014,100.0,0.0
6832,Fritz Lang's Indian Epic 2019 re-release,9345,9345,0,2019.csv,2019,100.0,0.0
6833,The End of Love,9342,9342,0,2013.csv,2013,100.0,0.0
6834,Looking for Maria Sanchez,9338,9338,0,2013.csv,2013,100.0,0.0
6835,The Immortalists,9331,9331,0,2014.csv,2014,100.0,0.0
6836,Better Mus' Come,9318,9318,0,2013.csv,2013,100.0,0.0
6837,Wonderful World,9309,9309,0,2010.csv,2010,100.0,0.0
6838,The City Dark,9269,9269,0,2012.csv,2012,100.0,0.0
6839,Hooligan Sparrow,9263,9263,0,2016.csv,2016,100.0,0.0
6840,The Sacrament,9221,9221,0,2014.csv,2014,100.0,0.0
6841,A Dark Place,9212,0,9212,2019.csv,2019,0.0,100.0
6842,Cracked Up,9197,9197,0,2019.csv,2019,100.0,0.0
6843,Ghost Team One,9195,9195,0,2013.csv,2013,100.0,0.0
6844,Trouble Every Day 2013 Re-release,9189,9189,0,2013.csv,2013,100.0,0.0
6845,Frank & Lola,9188,9188,0,2016.csv,2016,100.0,0.0
6846,The Hottest August,9163,9163,0,2019.csv,2019,100.0,0.0
6847,The Hollow Point,9149,0,9149,2016.csv,2016,0.0,100.0
6848,Just One More Kiss,9130,9130,0,2020.csv,2020,100.0,0.0
6849,Cupcakes,9129,9129,0,2015.csv,2015,100.0,0.0
6850,Thirst Street,9129,9129,0,2017.csv,2017,100.0,0.0
6851,Faith Connections,9111,9111,0,2014.csv,2014,100.0,0.0
6852,Lycan,9110,9110,0,2017.csv,2017,100.0,0.0
6853,The Eyes,9104,9104,0,2017.csv,2017,100.0,0.0
6854,Julian Schnabel: A Private Portrait,9103,9103,0,2017.csv,2017,100.0,0.0
6855,Decoding Deepak,9100,9100,0,2012.csv,2012,100.0,0.0
6856,Gerontophilia 2015 Re-release,9074,4916,4158,2015.csv,2015,54.17676878994931,45.82323121005069
6857,El Mar La Mar,9065,9065,0,2018.csv,2018,100.0,0.0
6858,Frantz Fanon: Black Skin White Mask,9025,9025,0,2019.csv,2019,100.0,0.0
6859,Step Up: High Water,9005,9005,0,2018.csv,2018,100.0,0.0
6860,Money Fight,9004,9004,0,2012.csv,2012,100.0,0.0
6861,Station to Station,9000,9000,0,2015.csv,2015,100.0,0.0
6862,Mosquita y Mari,9000,9000,0,2012.csv,2012,100.0,0.0
6863,Zoo Wars,8998,8998,0,2018.csv,2018,100.0,0.0
6864,Revolt,8986,0,8986,2017.csv,2017,0.0,100.0
6865,Survivors Guide To Prison,8982,8982,0,2018.csv,2018,100.0,0.0
6866,Colossal Youth,8968,8331,637,2018.csv,2018,92.89696699375558,7.1030330062444245
6867,Big Words,8965,8965,0,2013.csv,2013,100.0,0.0
6868,Three Stars,8942,8942,0,2012.csv,2012,100.0,0.0
6869,Summer of '67,8941,8941,0,2018.csv,2018,100.0,0.0
6870,Kindred,8921,8921,0,2020.csv,2020,100.0,0.0
6871,This is Congo,8905,7051,1854,2018.csv,2018,79.18023582257159,20.81976417742841
6872,B-Side,8870,8870,0,2015.csv,2015,100.0,0.0
6873,The Meanest Man in Texas,8850,8850,0,2019.csv,2019,100.0,0.0
6874,The Pardon,8845,8845,0,2015.csv,2015,100.0,0.0
6875,Providence,8840,8840,0,2016.csv,2016,100.0,0.0
6876,Home Run Showdown,8824,8824,0,2012.csv,2012,100.0,0.0
6877,That Part Feeling - the Universe of Arvo Part,8812,8812,0,2019.csv,2019,100.0,0.0
6878,The Cabinet of Dr. Caligari 2014 Re-release,8811,8811,0,2014.csv,2014,100.0,0.0
6879,Dawn of the Crescent Moon,8799,8799,0,2015.csv,2015,100.0,0.0
6880,Hell Baby,8785,8785,0,2013.csv,2013,100.0,0.0
6881,Only When I Dance,8738,8738,0,2010.csv,2010,100.0,0.0
6882,The Man in the White Suit,8718,8718,0,2012.csv,2012,100.0,0.0
6883,Blood Feast,8708,8708,0,2018.csv,2018,100.0,0.0
6884,Amnesia,8700,8700,0,2017.csv,2017,100.0,0.0
6885,Man on a Mission: Richard Garriott's Road to the Stars,8688,8688,0,2012.csv,2012,100.0,0.0
6886,Dosed,8643,0,8643,2019.csv,2019,0.0,100.0
6887,"Small, Beautifully Moving Parts",8631,8631,0,2012.csv,2012,100.0,0.0
6888,Meet Me in Montenegro,8612,8612,0,2015.csv,2015,100.0,0.0
6889,Almost Human,8608,8447,161,2014.csv,2014,98.1296468401487,1.8703531598513012
6890,Mojave,8602,8253,349,2016.csv,2016,95.94280399906998,4.057196000930016
6891,General Education,8601,8601,0,2012.csv,2012,100.0,0.0
6892,Farewell to Hollywood,8601,8601,0,2015.csv,2015,100.0,0.0
6893,Lucky,8564,8564,0,2011.csv,2011,100.0,0.0
6894,From the East,8540,8540,0,2016.csv,2016,100.0,0.0
6895,Inspector Maigret,8528,8528,0,2017.csv,2017,100.0,0.0
6896,The Quitter,8512,8512,0,2014.csv,2014,100.0,0.0
6897,The Empty Hours,8478,8244,234,2014.csv,2014,97.23991507430998,2.7600849256900215
6898,Furlough,8472,8472,0,2018.csv,2018,100.0,0.0
6899,Canopy,8462,8462,0,2014.csv,2014,100.0,0.0
6900,The Institute,8445,8445,0,2013.csv,2013,100.0,0.0
6901,We Are the Flesh,8438,8438,0,2017.csv,2017,100.0,0.0
6902,Hello Herman,8437,8437,0,2013.csv,2013,100.0,0.0
6903,Red Hollywood,8426,8426,0,2014.csv,2014,100.0,0.0
6904,The Happy Sad,8395,8395,0,2013.csv,2013,100.0,0.0
6905,LX 2048,8393,0,8393,2020.csv,2020,0.0,100.0
6906,Downloaded,8377,8377,0,2013.csv,2013,100.0,0.0
6907,Counting,8374,8374,0,2015.csv,2015,100.0,0.0
6908,Gilbert,8362,8362,0,2017.csv,2017,100.0,0.0
6909,Eternity: The Movie,8350,8350,0,2014.csv,2014,100.0,0.0
6910,Gringo Trails,8349,8349,0,2014.csv,2014,100.0,0.0
6911,A Teacher,8348,8348,0,2013.csv,2013,100.0,0.0
6912,Natasha,8325,8325,0,2017.csv,2017,100.0,0.0
6913,The Dead Center,8320,8320,0,2019.csv,2019,100.0,0.0
6914,About Cherry,8315,3003,5312,2012.csv,2012,36.115453998797356,63.884546001202644
6915,Mr. Chibbs,8302,8302,0,2017.csv,2017,100.0,0.0
6916,Served Like a Girl,8290,8290,0,2017.csv,2017,100.0,0.0
6917,We Are Twisted Fucking Sister!,8277,8277,0,2016.csv,2016,100.0,0.0
6918,Life Partners,8265,8265,0,2014.csv,2014,100.0,0.0
6919,Aliyah,8253,8253,0,2013.csv,2013,100.0,0.0
6920,Silicon Cowboys,8239,8239,0,2016.csv,2016,100.0,0.0
6921,The Etruscan Smile 2019 release,8213,8213,0,2019.csv,2019,100.0,0.0
6922,Brooklyn Brothers Beat the Best,8210,7466,744,2012.csv,2012,90.93788063337394,9.062119366626066
6923,Spiral,8190,8190,0,2018.csv,2018,100.0,0.0
6924,Jellyfish Eyes,8176,8176,0,2015.csv,2015,100.0,0.0
6925,Anatahan,8171,8171,0,2017.csv,2017,100.0,0.0
6926,The Other Side,8168,8074,94,2016.csv,2016,98.84916748285994,1.1508325171400589
6927,Inside the Rain,8140,8140,0,2020.csv,2020,100.0,0.0
6928,Far from Vietnam,8132,8132,0,2013.csv,2013,100.0,0.0
6929,From Nowhere,8109,8109,0,2017.csv,2017,100.0,0.0
6930,The Wave,8101,8101,0,2020.csv,2020,100.0,0.0
6931,Restless City,8100,8100,0,2012.csv,2012,100.0,0.0
6932,Next Year Jerusalem,8093,8093,0,2014.csv,2014,100.0,0.0
6933,Golden Kingdom,8077,8077,0,2016.csv,2016,100.0,0.0
6934,Steak (R)evolution,8038,8025,13,2015.csv,2015,99.83826822592685,0.16173177407315253
6935,Straight Outta Tompkins,8022,8022,0,2015.csv,2015,100.0,0.0
6936,Talent Has Hunger,7998,7998,0,2016.csv,2016,100.0,0.0
6937,All About Evil,7995,7995,0,2010.csv,2010,100.0,0.0
6938,One Small Hitch 2015 Re-release,7965,7965,0,2015.csv,2015,100.0,0.0
6939,Roseanne for President!,7960,7960,0,2016.csv,2016,100.0,0.0
6940,Stolen,7943,7943,0,2010.csv,2010,100.0,0.0
6941,Mugabe and the White African,7924,7924,0,2010.csv,2010,100.0,0.0
6942,Angels Are Made Of Light,7919,7919,0,2019.csv,2019,100.0,0.0
6943,Portrait of a Garden,7914,7914,0,2016.csv,2016,100.0,0.0
6944,Bleak Street,7888,0,7888,2015.csv,2015,0.0,100.0
6945,This Magnificent Cake!,7888,7888,0,2019.csv,2019,100.0,0.0
6946,I AM PATRICK,7880,0,7880,2020.csv,2020,0.0,100.0
6947,Swept Away,7876,7876,0,2017.csv,2017,100.0,0.0
6948,Zenith,7862,7862,0,2010.csv,2010,100.0,0.0
6949,The Ballad of Lefty Brown,7856,7856,0,2017.csv,2017,100.0,0.0
6950,Ghost Fleet,7850,7850,0,2019.csv,2019,100.0,0.0
6951,Roadie,7825,7825,0,2012.csv,2012,100.0,0.0
6952,Photographic Memory,7822,7822,0,2012.csv,2012,100.0,0.0
6953,The Great Man,7814,7814,0,2015.csv,2015,100.0,0.0
6954,Archipelago 2014 Re-release,7791,7791,0,2014.csv,2014,100.0,0.0
6955,Dreaming Grand Avenue,7789,7789,0,2020.csv,2020,100.0,0.0
6956,The Plagiarists,7768,7768,0,2019.csv,2019,100.0,0.0
6957,Old Stone,7768,7476,292,2016.csv,2016,96.2409886714727,3.7590113285272917
6958,And While We Were Here,7750,7750,0,2013.csv,2013,100.0,0.0
6959,Come Back to Me,7744,7744,0,2014.csv,2014,100.0,0.0
6960,Young Ones,7740,0,7740,2014.csv,2014,0.0,100.0
6961,Gregory's Girl,7710,7710,0,2019.csv,2019,100.0,0.0
6962,Maurizio Cattelan: Be Right Back,7706,7706,0,2017.csv,2017,100.0,0.0
6963,I Don't Belong Anywhere: The Cinema of Chantal Akerman,7703,7703,0,2016.csv,2016,100.0,0.0
6964,Running Shaadi,7674,0,7674,2017.csv,2017,0.0,100.0
6965,Valley Girl,7671,0,7671,2020.csv,2020,0.0,100.0
6966,Last Days Here,7643,7643,0,2012.csv,2012,100.0,0.0
6967,Legend of the Mountain,7640,7640,0,2018.csv,2018,100.0,0.0
6968,Psycho Raman,7612,0,7612,2016.csv,2016,0.0,100.0
6969,Area 51,7556,7556,0,2015.csv,2015,100.0,0.0
6970,The Wrong Light,7553,7553,0,2017.csv,2017,100.0,0.0
6971,Tales from the Script,7535,7535,0,2010.csv,2010,100.0,0.0
6972,Girls Against Boys,7529,7529,0,2013.csv,2013,100.0,0.0
6973,Birthright: A War Story,7519,7519,0,2017.csv,2017,100.0,0.0
6974,Udaan,7461,7461,0,2010.csv,2010,100.0,0.0
6975,The Little Bedroom 2014 Re-release,7440,7440,0,2014.csv,2014,100.0,0.0
6976,Raze,7429,7429,0,2014.csv,2014,100.0,0.0
6977,Bel Borba Aqui,7426,7426,0,2012.csv,2012,100.0,0.0
6978,Rubble Kings,7416,7416,0,2015.csv,2015,100.0,0.0
6979,Price Check,7413,7413,0,2012.csv,2012,100.0,0.0
6980,The Giant Mechanical Man,7396,7396,0,2012.csv,2012,100.0,0.0
6981,The Other Lamb,7385,6024,1361,2020.csv,2020,81.57075152335815,18.429248476641842
6982,Desperate Acts of Magic,7373,7373,0,2013.csv,2013,100.0,0.0
6983,Big Time,7347,7347,0,2017.csv,2017,100.0,0.0
6984,Shoah: Four Sisters,7323,7323,0,2018.csv,2018,100.0,0.0
6985,Beloved Beast,7301,7301,0,2019.csv,2019,100.0,0.0
6986,Gangster's Paradise: Jerusalema 2010 Re-release,7294,7294,0,2010.csv,2010,100.0,0.0
6987,Another WolfCop,7285,7285,0,2017.csv,2017,100.0,0.0
6988,Indian Point,7251,7251,0,2016.csv,2016,100.0,0.0
6989,Outside Satan,7226,0,7226,2013.csv,2013,0.0,100.0
6990,Tall: The American Skyscraper and Louis Sullivan,7216,7216,0,2018.csv,2018,100.0,0.0
6991,I Am Ali,7205,7205,0,2014.csv,2014,100.0,0.0
6992,London River 2011 Re-release,7200,7200,0,2011.csv,2011,100.0,0.0
6993,Happiness Runs,7199,7199,0,2010.csv,2010,100.0,0.0
6994,Antarctic Edge: 70° South,7193,7193,0,2015.csv,2015,100.0,0.0
6995,The Strange Color of Your Body's Tears,7182,7182,0,2014.csv,2014,100.0,0.0
6996,ABCs of Death 2,7171,7171,0,2014.csv,2014,100.0,0.0
6997,It Had to Be You,7162,7162,0,2016.csv,2016,100.0,0.0
6998,"Brutti, sporchi e cattivi",7144,7144,0,2016.csv,2016,100.0,0.0
6999,Logan,7137,7137,0,2010.csv,2010,100.0,0.0
7000,The Reagan Show,7109,5500,1609,2017.csv,2017,77.36671824447883,22.63328175552117
7001,Domain 2012 Re-release,7105,7105,0,2012.csv,2012,100.0,0.0
7002,The Jazz Funeral,7103,7103,0,2017.csv,2017,100.0,0.0
7003,The Dark Below,7095,7095,0,2017.csv,2017,100.0,0.0
7004,Painless,7082,7082,0,2018.csv,2018,100.0,0.0
7005,Stage Fright,7078,7078,0,2014.csv,2014,100.0,0.0
7006,Good Neighbours,7072,7072,0,2011.csv,2011,100.0,0.0
7007,In Echo Park,7072,7072,0,2018.csv,2018,100.0,0.0
7008,The Brainwashing of My Dad,7028,7028,0,2016.csv,2016,100.0,0.0
7009,In the Land of Pomegranates,7014,7014,0,2018.csv,2018,100.0,0.0
7010,Corman's World: Exploits of a Hollywood Rebel,7000,7000,0,2011.csv,2011,100.0,0.0
7011,The Brass Teapot,6997,6997,0,2013.csv,2013,100.0,0.0
7012,I Am Lisa,6986,6986,0,2020.csv,2020,100.0,0.0
7013,What We Found,6976,6976,0,2020.csv,2020,100.0,0.0
7014,Gabriel,6959,6959,0,2015.csv,2015,100.0,0.0
7015,"Love, Marilyn",6950,6950,0,2012.csv,2012,100.0,0.0
7016,A Kind of Loving,6912,6912,0,2017.csv,2017,100.0,0.0
7017,Assaulted: Civil Rights Under Fire,6905,6905,0,2013.csv,2013,100.0,0.0
7018,Boom Bust Boom,6896,6896,0,2016.csv,2016,100.0,0.0
7019,Misconceptions,6892,6892,0,2010.csv,2010,100.0,0.0
7020,Sal,6883,6883,0,2013.csv,2013,100.0,0.0
7021,The Human Scale,6878,6878,0,2013.csv,2013,100.0,0.0
7022,Duck Butter,6877,6877,0,2018.csv,2018,100.0,0.0
7023,The Sisterhood of Night,6870,6870,0,2015.csv,2015,100.0,0.0
7024,Last Ride 2012 Re-release,6853,6853,0,2012.csv,2012,100.0,0.0
7025,Janie Jones,6840,6840,0,2011.csv,2011,100.0,0.0
7026,Mad Tiger,6823,6823,0,2016.csv,2016,100.0,0.0
7027,12 Hour Shift,6820,6820,0,2020.csv,2020,100.0,0.0
7028,"No God, No Master",6796,6796,0,2014.csv,2014,100.0,0.0
7029,Finding Bliss,6783,6783,0,2010.csv,2010,100.0,0.0
7030,Mercy,6780,6780,0,2010.csv,2010,100.0,0.0
7031,Going Attractions: The Definitive Story of the Movie Palace,6763,6763,0,2019.csv,2019,100.0,0.0
7032,Calling All Earthlings,6756,6756,0,2018.csv,2018,100.0,0.0
7033,Dying to Survive 2019 Re-release,6752,6752,0,2019.csv,2019,100.0,0.0
7034,A Whale of a Tale,6747,6747,0,2018.csv,2018,100.0,0.0
7035,Iceman,6719,2138,4581,2018.csv,2018,31.82021134097336,68.17978865902664
7036,Before You Know It,6717,6717,0,2014.csv,2014,100.0,0.0
7037,Regina Spektor Live in London,6684,6684,0,2010.csv,2010,100.0,0.0
7038,Arabian Nights: Volume 3 - The Enchanted One,6681,4502,2179,2015.csv,2015,67.3851219877264,32.614878012273614
7039,Footnotes 2017 Re-release,6660,6660,0,2017.csv,2017,100.0,0.0
7040,Ghost Team,6639,6639,0,2016.csv,2016,100.0,0.0
7041,The Persian Connection,6634,6634,0,2017.csv,2017,100.0,0.0
7042,Breakfast with Curtis,6629,6629,0,2013.csv,2013,100.0,0.0
7043,The Dying of the Light,6627,6627,0,2016.csv,2016,100.0,0.0
7044,Brief Reunion,6601,6601,0,2013.csv,2013,100.0,0.0
7045,Aatsinki: The Story of Arctic Cowboys,6601,6601,0,2014.csv,2014,100.0,0.0
7046,Human Capital,6596,6596,0,2020.csv,2020,100.0,0.0
7047,Down the Shore,6558,6558,0,2013.csv,2013,100.0,0.0
7048,In Our Nature,6543,6543,0,2012.csv,2012,100.0,0.0
7049,Elizabeth Blue,6542,6542,0,2017.csv,2017,100.0,0.0
7050,Dream Boy,6534,6534,0,2010.csv,2010,100.0,0.0
7051,Spiral Farm,6517,6517,0,2019.csv,2019,100.0,0.0
7052,Horse Money,6508,6508,0,2015.csv,2015,100.0,0.0
7053,Jews of Egypt,6505,6505,0,2014.csv,2014,100.0,0.0
7054,Windfall,6504,6504,0,2012.csv,2012,100.0,0.0
7055,Ride,6489,0,6489,2015.csv,2015,0.0,100.0
7056,The Beat Hotel,6480,6480,0,2012.csv,2012,100.0,0.0
7057,Afterward,6477,6477,0,2020.csv,2020,100.0,0.0
7058,Scum,6461,6461,0,2017.csv,2017,100.0,0.0
7059,Tu Dors Nicole,6445,5662,783,2015.csv,2015,87.85104732350659,12.148952676493407
7060,The Suicide Theory,6434,6434,0,2015.csv,2015,100.0,0.0
7061,Some Velvet Morning,6420,6420,0,2013.csv,2013,100.0,0.0
7062,100 Bloody Acres,6388,6388,0,2013.csv,2013,100.0,0.0
7063,Inescapable,6334,6334,0,2013.csv,2013,100.0,0.0
7064,The Charnel House,6332,6332,0,2016.csv,2016,100.0,0.0
7065,Watercolors,6305,6305,0,2010.csv,2010,100.0,0.0
7066,Manuscripts Don't Burn,6295,6295,0,2014.csv,2014,100.0,0.0
7067,Under the Eiffel Tower,6291,6291,0,2019.csv,2019,100.0,0.0
7068,The Skyjacker's Tale,6253,6253,0,2017.csv,2017,100.0,0.0
7069,One Last Thing,6232,6232,0,2018.csv,2018,100.0,0.0
7070,In the Steps of Trisha Brown,6230,6230,0,2017.csv,2017,100.0,0.0
7071,The Bad Kids,6226,6226,0,2016.csv,2016,100.0,0.0
7072,A Man Vanishes 2012 Re-release,6201,6201,0,2012.csv,2012,100.0,0.0
7073,The Red Chapel,6196,6196,0,2010.csv,2010,100.0,0.0
7074,The Night of the Shooting Stars 2015 Re-release,6186,6186,0,2015.csv,2015,100.0,0.0
7075,To Be of Service,6173,6173,0,2019.csv,2019,100.0,0.0
7076,Sweetwater,6147,6147,0,2013.csv,2013,100.0,0.0
7077,Crazy Eyes,6141,6141,0,2012.csv,2012,100.0,0.0
7078,Relaxer,6133,6133,0,2019.csv,2019,100.0,0.0
7079,Guitar Innovators: John Fahey & Nels Cline,6132,6132,0,2013.csv,2013,100.0,0.0
7080,"El Sicario, Room 164",6123,6123,0,2011.csv,2011,100.0,0.0
7081,Welcome to Pine Hill,6115,6115,0,2013.csv,2013,100.0,0.0
7082,Arise from Darkness,6112,6112,0,2017.csv,2017,100.0,0.0
7083,Rangrezz,6108,6108,0,2013.csv,2013,100.0,0.0
7084,The Last Fall,6100,6100,0,2012.csv,2012,100.0,0.0
7085,The Last Time I Saw Macao,6095,6095,0,2013.csv,2013,100.0,0.0
7086,The Fuzz,6067,6067,0,2017.csv,2017,100.0,0.0
7087,The Miners' Hymns,6051,6051,0,2012.csv,2012,100.0,0.0
7088,The Marquise of O,6048,6048,0,2015.csv,2015,100.0,0.0
7089,Love & Air Sex,6047,6047,0,2014.csv,2014,100.0,0.0
7090,Blood Widow,6047,6047,0,2019.csv,2019,100.0,0.0
7091,The Family Tree,6035,6035,0,2011.csv,2011,100.0,0.0
7092,BearCity,6000,6000,0,2010.csv,2010,100.0,0.0
7093,On Wings of Eagles 2017 Re-release,5975,5975,0,2017.csv,2017,100.0,0.0
7094,"Sex, Death and Bowling",5972,5972,0,2015.csv,2015,100.0,0.0
7095,The Playroom,5964,5964,0,2013.csv,2013,100.0,0.0
7096,Cavemen,5948,5948,0,2014.csv,2014,100.0,0.0
7097,Starless Dreams,5937,5937,0,2017.csv,2017,100.0,0.0
7098,American Animal,5928,5928,0,2012.csv,2012,100.0,0.0
7099,Sweethearts of the Prison Rodeo,5922,5922,0,2010.csv,2010,100.0,0.0
7100,I Am MLK Jr.,5918,5918,0,2018.csv,2018,100.0,0.0
7101,Gang of Ghosts,5906,5906,0,2014.csv,2014,100.0,0.0
7102,Slash,5902,5902,0,2016.csv,2016,100.0,0.0
7103,Medeas,5895,5895,0,2015.csv,2015,100.0,0.0
7104,An Actor Prepares,5891,1743,4148,2018.csv,2018,29.587506365642508,70.4124936343575
7105,Infliction,5875,5875,0,2014.csv,2014,100.0,0.0
7106,The Imperialists Are Still Alive!,5874,5874,0,2011.csv,2011,100.0,0.0
7107,Empire of Silver 2011 Re-release,5867,0,5867,2011.csv,2011,0.0,100.0
7108,BuzzKill,5860,5860,0,2012.csv,2012,100.0,0.0
7109,Top Spin,5858,5858,0,2015.csv,2015,100.0,0.0
7110,Bourek,5844,5844,0,2016.csv,2016,100.0,0.0
7111,Shout Gladi Gladi,5839,5839,0,2015.csv,2015,100.0,0.0
7112,Human Nature,5834,5487,347,2019.csv,2019,94.05210833047651,5.947891669523483
7113,Five Dances,5788,5788,0,2013.csv,2013,100.0,0.0
7114,Black November,5782,5782,0,2015.csv,2015,100.0,0.0
7115,Undrafted,5777,5777,0,2016.csv,2016,100.0,0.0
7116,Lie Exposed,5775,5775,0,2020.csv,2020,100.0,0.0
7117,In the Life of Music,5772,5772,0,2020.csv,2020,100.0,0.0
7118,Sushi: The Global Catch,5757,5757,0,2012.csv,2012,100.0,0.0
7119,A Dark Truth,5750,5750,0,2013.csv,2013,100.0,0.0
7120,Sex and the Future,5745,5745,0,2020.csv,2020,100.0,0.0
7121,Love Goes Public,5738,5738,0,2019.csv,2019,100.0,0.0
7122,Save the Date,5719,5719,0,2012.csv,2012,100.0,0.0
7123,The Wanted 18,5680,5680,0,2015.csv,2015,100.0,0.0
7124,People of a Feather,5677,5677,0,2013.csv,2013,100.0,0.0
7125,The Fall of Night,5673,5673,0,2010.csv,2010,100.0,0.0
7126,Knife Fight,5661,5661,0,2013.csv,2013,100.0,0.0
7127,Papirosen,5658,5658,0,2014.csv,2014,100.0,0.0
7128,This Isn't Funny,5654,5654,0,2015.csv,2015,100.0,0.0
7129,Série noire,5633,5633,0,2019.csv,2019,100.0,0.0
7130,La Chinoise 2017 Re-release,5631,5631,0,2017.csv,2017,100.0,0.0
7131,Elevate,5580,5580,0,2011.csv,2011,100.0,0.0
7132,Our Man in Tehran,5573,5573,0,2015.csv,2015,100.0,0.0
7133,Kid Cannabis,5565,5565,0,2014.csv,2014,100.0,0.0
7134,Find Your Voice,5560,5560,0,2020.csv,2020,100.0,0.0
7135,The Miracle of the Little Prince,5553,5553,0,2019.csv,2019,100.0,0.0
7136,Booker's Place: A Mississippi Story,5549,5549,0,2012.csv,2012,100.0,0.0
7137,American Grindhouse,5529,5529,0,2010.csv,2010,100.0,0.0
7138,Are We Not Cats,5518,5518,0,2018.csv,2018,100.0,0.0
7139,The Living,5514,5514,0,2015.csv,2015,100.0,0.0
7140,Icaros: A Vision,5510,5510,0,2017.csv,2017,100.0,0.0
7141,The Man from Earth: Holocene,5472,5472,0,2017.csv,2017,100.0,0.0
7142,Cuban Food Stories,5434,5434,0,2018.csv,2018,100.0,0.0
7143,Flex Is Kings,5418,5418,0,2014.csv,2014,100.0,0.0
7144,Whiz Kids,5386,5386,0,2010.csv,2010,100.0,0.0
7145,The Only Real Game,5384,5384,0,2014.csv,2014,100.0,0.0
7146,She's Lost Control,5319,5319,0,2015.csv,2015,100.0,0.0
7147,The Time Being,5274,5274,0,2013.csv,2013,100.0,0.0
7148,It's Not Yet Dark,5269,1227,4042,2017.csv,2017,23.28715126209907,76.71284873790093
7149,Still Here,5268,5268,0,2020.csv,2020,100.0,0.0
7150,Killers,5248,0,5248,2014.csv,2014,0.0,100.0
7151,Sarajevo,5247,5247,0,2015.csv,2015,100.0,0.0
7152,Speed-Dating,5240,5240,0,2010.csv,2010,100.0,0.0
7153,The Princess of France,5212,5212,0,2015.csv,2015,100.0,0.0
7154,Death Valley,5211,5211,0,2015.csv,2015,100.0,0.0
7155,In Searching,5210,5210,0,2018.csv,2018,100.0,0.0
7156,Chokehold,5200,5200,0,2019.csv,2019,100.0,0.0
7157,The Gliksmans,5166,5166,0,2019.csv,2019,100.0,0.0
7158,And They're Off,5154,5154,0,2011.csv,2011,100.0,0.0
7159,100 Acres of Hell,5152,5152,0,2019.csv,2019,100.0,0.0
7160,To Die Is Hard,5129,5129,0,2010.csv,2010,100.0,0.0
7161,Body at Brighton Rock,5123,5123,0,2019.csv,2019,100.0,0.0
7162,Return to Nuke 'Em High Volume 1,5122,5122,0,2014.csv,2014,100.0,0.0
7163,Intersection,5116,5116,0,2018.csv,2018,100.0,0.0
7164,Bad Lucky Goat,5088,5088,0,2017.csv,2017,100.0,0.0
7165,On War 2015 Re-release,5086,5086,0,2015.csv,2015,100.0,0.0
7166,Welcome to Happiness,5083,5083,0,2016.csv,2016,100.0,0.0
7167,2307: Winter's Dream,5078,0,5078,2017.csv,2017,0.0,100.0
7168,Bidder 70,5074,5074,0,2013.csv,2013,100.0,0.0
7169,Tanner Hall,5073,5073,0,2011.csv,2011,100.0,0.0
7170,Notes on an Appearance,5065,5065,0,2018.csv,2018,100.0,0.0
7171,Chulas Fronteras,5021,5021,0,2019.csv,2019,100.0,0.0
7172,The Sleepwalker,5012,5012,0,2014.csv,2014,100.0,0.0
7173,The Texture of Falling,5010,5010,0,2018.csv,2018,100.0,0.0
7174,Downtown Express,5010,5010,0,2012.csv,2012,100.0,0.0
7175,Social Animals,5007,5007,0,2018.csv,2018,100.0,0.0
7176,The Garden,5006,5006,0,2019.csv,2019,100.0,0.0
7177,An L.A. Minute,5004,5004,0,2018.csv,2018,100.0,0.0
7178,Newlyweds,5000,5000,0,2012.csv,2012,100.0,0.0
7179,Weekend of a Champion,4976,4100,876,2013.csv,2013,82.39549839228296,17.60450160771704
7180,Bringing Up Bobby,4975,4975,0,2012.csv,2012,100.0,0.0
7181,Ottolenghi and the Cakes of Versailles,4962,4962,0,2020.csv,2020,100.0,0.0
7182,sxtape,4961,0,4961,2014.csv,2014,0.0,100.0
7183,Futaba kara tooku hanarete,4960,4960,0,2013.csv,2013,100.0,0.0
7184,Herman's House,4956,4956,0,2013.csv,2013,100.0,0.0
7185,To Die Like a Man,4955,4029,926,2011.csv,2011,81.31180625630677,18.68819374369324
7186,SBK: The Movie,4950,4950,0,2015.csv,2015,100.0,0.0
7187,Tournament,4942,4942,0,2017.csv,2017,100.0,0.0
7188,Company Town,4934,4934,0,2017.csv,2017,100.0,0.0
7189,Supporting Characters,4917,4917,0,2013.csv,2013,100.0,0.0
7190,Guidance,4900,4900,0,2015.csv,2015,100.0,0.0
7191,Malek,4898,4898,0,2019.csv,2019,100.0,0.0
7192,Revelation Road 2: The Sea of Glass and Fire,4871,4871,0,2013.csv,2013,100.0,0.0
7193,Nothing Bad Can Happen,4870,4870,0,2014.csv,2014,100.0,0.0
7194,Crepitus,4846,4846,0,2019.csv,2019,100.0,0.0
7195,Call Her Applebroog,4842,4842,0,2016.csv,2016,100.0,0.0
7196,Ballet Blanc,4832,4832,0,2019.csv,2019,100.0,0.0
7197,Ferlinghetti: A Rebirth of Wonder,4816,4816,0,2013.csv,2013,100.0,0.0
7198,"Half The Road: The Passion, Pitfalls & Power of Women's Professional Cycling",4783,4783,0,2014.csv,2014,100.0,0.0
7199,Behind the White Glasses,4770,2223,2547,2016.csv,2016,46.60377358490566,53.39622641509434
7200,Miss Hill: Making Dance Matter,4706,4706,0,2015.csv,2015,100.0,0.0
7201,Shot,4701,4701,0,2017.csv,2017,100.0,0.0
7202,Marinoni: The Fire in the Frame,4696,4696,0,2016.csv,2016,100.0,0.0
7203,The Other Side of Everything,4685,4685,0,2018.csv,2018,100.0,0.0
7204,Death Metal Angola,4674,4674,0,2014.csv,2014,100.0,0.0
7205,The Long Dumb Road,4667,4667,0,2018.csv,2018,100.0,0.0
7206,Blood on the Mountain,4664,4664,0,2016.csv,2016,100.0,0.0
7207,Night School,4663,4663,0,2017.csv,2017,100.0,0.0
7208,I Love You Both,4661,4661,0,2017.csv,2017,100.0,0.0
7209,Shakespeare-Wallah,4650,4650,0,2017.csv,2017,100.0,0.0
7210,Against the Sun,4646,4646,0,2015.csv,2015,100.0,0.0
7211,Seeds of Time,4630,4630,0,2015.csv,2015,100.0,0.0
7212,Miss Stevens,4611,4611,0,2016.csv,2016,100.0,0.0
7213,The Automatic Hate,4603,4603,0,2016.csv,2016,100.0,0.0
7214,Protector 2010 Re-release,4576,2968,1608,2010.csv,2010,64.86013986013987,35.13986013986014
7215,Search Party 2016 Re-release,4571,4571,0,2016.csv,2016,100.0,0.0
7216,Smiling Through the Apocalypse,4560,4560,0,2014.csv,2014,100.0,0.0
7217,All Is Bright,4556,4556,0,2013.csv,2013,100.0,0.0
7218,A Boy Called Po,4550,4550,0,2017.csv,2017,100.0,0.0
7219,Promised Lands,4546,4546,0,2010.csv,2010,100.0,0.0
7220,Here Comes the Devil,4534,4534,0,2013.csv,2013,100.0,0.0
7221,Weightless,4530,4461,69,2018.csv,2018,98.47682119205298,1.5231788079470199
7222,Unrelated 2014 Re-release,4529,4529,0,2014.csv,2014,100.0,0.0
7223,Synchronicity,4505,4505,0,2016.csv,2016,100.0,0.0
7224,The Pulitzer at 100,4489,4489,0,2017.csv,2017,100.0,0.0
7225,I'm Leaving Now,4488,4488,0,2019.csv,2019,100.0,0.0
7226,German Concentration Camps Factual Survey,4468,4468,0,2017.csv,2017,100.0,0.0
7227,"Farewell, Herr Schwarz",4445,4445,0,2015.csv,2015,100.0,0.0
7228,Generation Iron 2,4439,4439,0,2017.csv,2017,100.0,0.0
7229,SGT. Will Gardner,4405,4405,0,2019.csv,2019,100.0,0.0
7230,The Truth About Emanuel,4404,4404,0,2014.csv,2014,100.0,0.0
7231,The Peacemaker,4400,4400,0,2018.csv,2018,100.0,0.0
7232,30-LOVE,4392,4392,0,2017.csv,2017,100.0,0.0
7233,Between Us,4380,4380,0,2013.csv,2013,100.0,0.0
7234,The End of Time,4375,4375,0,2013.csv,2013,100.0,0.0
7235,The Woman Who Left,4373,3974,399,2017.csv,2017,90.87582895037731,9.124171049622683
7236,The Catechism Cataclysm,4373,4373,0,2011.csv,2011,100.0,0.0
7237,The Party's Just Beginning,4371,4145,226,2018.csv,2018,94.82955845344316,5.170441546556852
7238,The Flower of Kim Jong II,4362,4362,0,2010.csv,2010,100.0,0.0
7239,Tito and the Birds,4332,4332,0,2019.csv,2019,100.0,0.0
7240,On Meditation,4322,4322,0,2016.csv,2016,100.0,0.0
7241,Days of Grace 2015 Re-release,4308,4308,0,2015.csv,2015,100.0,0.0
7242,The Tower,4305,1117,3188,2014.csv,2014,25.9465737514518,74.0534262485482
7243,Auto Shop of Horrors,4300,4300,0,2016.csv,2016,100.0,0.0
7244,The Fate of Lee Khan,4295,4295,0,2019.csv,2019,100.0,0.0
7245,Art Is... The Permanent Revolution,4291,4291,0,2012.csv,2012,100.0,0.0
7246,State Like Sleep,4282,4282,0,2019.csv,2019,100.0,0.0
7247,Set Fire to the Stars,4280,4280,0,2015.csv,2015,100.0,0.0
7248,The Knife of Don Juan,4254,4254,0,2015.csv,2015,100.0,0.0
7249,My Father Die,4252,4252,0,2017.csv,2017,100.0,0.0
7250,Cocote,4224,3815,409,2018.csv,2018,90.31723484848484,9.682765151515152
7251,Maximum Ride,4218,4218,0,2016.csv,2016,100.0,0.0
7252,Stella's Last Weekend,4215,4215,0,2018.csv,2018,100.0,0.0
7253,Breaking a Monster,4212,4212,0,2016.csv,2016,100.0,0.0
7254,Free the Nipple,4198,4198,0,2014.csv,2014,100.0,0.0
7255,Helena from the Wedding,4190,4190,0,2010.csv,2010,100.0,0.0
7256,Among the Believers,4189,4189,0,2016.csv,2016,100.0,0.0
7257,3 Geezers!,4175,4175,0,2013.csv,2013,100.0,0.0
7258,Daylight,4171,4171,0,2011.csv,2011,100.0,0.0
7259,Badsville,4153,4153,0,2017.csv,2017,100.0,0.0
7260,Pawn,4141,4141,0,2013.csv,2013,100.0,0.0
7261,Chinese Portrait,4140,4140,0,2019.csv,2019,100.0,0.0
7262,Contracted,4105,4105,0,2013.csv,2013,100.0,0.0
7263,Jason Becker: Not Dead Yet,4080,1294,2786,2012.csv,2012,31.715686274509803,68.2843137254902
7264,Silver Circle,4080,4080,0,2013.csv,2013,100.0,0.0
7265,Three Night Stand,4076,4076,0,2015.csv,2015,100.0,0.0
7266,The Kitchen,4054,4054,0,2013.csv,2013,100.0,0.0
7267,La Flor,4032,4032,0,2019.csv,2019,100.0,0.0
7268,Morning,4029,4029,0,2013.csv,2013,100.0,0.0
7269,Approved for Adoption 2013 Re-release,4015,4015,0,2013.csv,2013,100.0,0.0
7270,Yangsi,4008,4008,0,2012.csv,2012,100.0,0.0
7271,Pickin' & Grinnin',4000,4000,0,2012.csv,2012,100.0,0.0
7272,Building Hope,4000,4000,0,2011.csv,2011,100.0,0.0
7273,Campus Radio,4000,4000,0,2011.csv,2011,100.0,0.0
7274,Emily,3982,3982,0,2017.csv,2017,100.0,0.0
7275,Dream Boat,3981,3981,0,2017.csv,2017,100.0,0.0
7276,Armed,3948,3948,0,2018.csv,2018,100.0,0.0
7277,Just Say Love,3944,3944,0,2010.csv,2010,100.0,0.0
7278,Mother of a Day,3919,3919,0,2019.csv,2019,100.0,0.0
7279,Maidan,3909,3909,0,2014.csv,2014,100.0,0.0
7280,American Dresser,3895,3895,0,2018.csv,2018,100.0,0.0
7281,The Iron Ministry,3885,3340,545,2015.csv,2015,85.97168597168597,14.028314028314028
7282,Crown Vic,3868,3868,0,2019.csv,2019,100.0,0.0
7283,Hollidaysburg,3861,3861,0,2014.csv,2014,100.0,0.0
7284,The Second Time Around,3837,3837,0,2018.csv,2018,100.0,0.0
7285,"High Tech, Low Life",3836,3836,0,2013.csv,2013,100.0,0.0
7286,Aashayein,3836,0,3836,2010.csv,2010,0.0,100.0
7287,King's Gambit,3816,3816,0,2020.csv,2020,100.0,0.0
7288,Free Radicals: A History of Experimental Film,3804,3804,0,2012.csv,2012,100.0,0.0
7289,Wallflower,3801,3801,0,2019.csv,2019,100.0,0.0
7290,Unfreedom,3778,3778,0,2015.csv,2015,100.0,0.0
7291,They Come to America,3775,3775,0,2012.csv,2012,100.0,0.0
7292,The Gender Card Flip,3774,3774,0,2017.csv,2017,100.0,0.0
7293,In/Significant Others,3763,3763,0,2010.csv,2010,100.0,0.0
7294,The Hollow,3755,3755,0,2016.csv,2016,100.0,0.0
7295,Nelly,3751,3751,0,2018.csv,2018,100.0,0.0
7296,Bugs,3742,3742,0,2017.csv,2017,100.0,0.0
7297,Bad Blood,3731,3731,0,2012.csv,2012,100.0,0.0
7298,The Free Speech Apocalypse,3726,3726,0,2015.csv,2015,100.0,0.0
7299,The Condemned,3718,3718,0,2013.csv,2013,100.0,0.0
7300,The Harvest/La Cosecha,3709,3709,0,2011.csv,2011,100.0,0.0
7301,Heartless,3697,3697,0,2010.csv,2010,100.0,0.0
7302,The Family,3696,3696,0,2018.csv,2018,100.0,0.0
7303,The Word,3648,3648,0,2014.csv,2014,100.0,0.0
7304,Smash His Camera,3644,3644,0,2010.csv,2010,100.0,0.0
7305,Stop The Pounding Heart,3642,3642,0,2014.csv,2014,100.0,0.0
7306,The Wandering Soap Opera,3624,3624,0,2019.csv,2019,100.0,0.0
7307,Mr. Nobody 2013 Re-release,3622,3622,0,2013.csv,2013,100.0,0.0
7308,Hyena,3586,3401,185,2015.csv,2015,94.8410485220301,5.158951477969883
7309,Hide Your Smiling Faces,3576,3576,0,2014.csv,2014,100.0,0.0
7310,Evolution of a Criminal,3568,3568,0,2014.csv,2014,100.0,0.0
7311,The Last Film Festival,3558,3558,0,2016.csv,2016,100.0,0.0
7312,Fourplay,3550,3550,0,2018.csv,2018,100.0,0.0
7313,The Beautiful Troublemaker 2017 Re-release,3540,3540,0,2017.csv,2017,100.0,0.0
7314,Tricked,3533,3533,0,2013.csv,2013,100.0,0.0
7315,The Loving Story 2016 Re-release,3518,3518,0,2016.csv,2016,100.0,0.0
7316,Who's Crazy?,3497,3497,0,2017.csv,2017,100.0,0.0
7317,Locker 13,3496,3496,0,2014.csv,2014,100.0,0.0
7318,The Citizen 2018 Re-release,3495,3495,0,2018.csv,2018,100.0,0.0
7319,Dead Awake,3484,0,3484,2010.csv,2010,0.0,100.0
7320,"Love, Sweat and Tears",3482,3482,0,2017.csv,2017,100.0,0.0
7321,Metal Messiah,3476,3476,0,2010.csv,2010,100.0,0.0
7322,The Hacker Wars,3470,3470,0,2014.csv,2014,100.0,0.0
7323,The Full Picture,3467,3467,0,2010.csv,2010,100.0,0.0
7324,Aftermath,3451,3451,0,2014.csv,2014,100.0,0.0
7325,Life's a Breeze 2014 Re-release,3450,3450,0,2014.csv,2014,100.0,0.0
7326,Scenic Route,3434,3434,0,2013.csv,2013,100.0,0.0
7327,Mahogany Sunrise,3432,3432,0,2014.csv,2014,100.0,0.0
7328,Restored Me 2016 Re-release,3428,3428,0,2016.csv,2016,100.0,0.0
7329,Speed Sisters,3423,3423,0,2017.csv,2017,100.0,0.0
7330,The Happy Poet,3400,3400,0,2013.csv,2013,100.0,0.0
7331,The Cage Fighter,3392,3392,0,2018.csv,2018,100.0,0.0
7332,Rottentail,3383,3383,0,2019.csv,2019,100.0,0.0
7333,Amanda & Jack Go Glamping,3352,3352,0,2017.csv,2017,100.0,0.0
7334,Bad Match,3351,3351,0,2017.csv,2017,100.0,0.0
7335,Followers,3350,3350,0,2018.csv,2018,100.0,0.0
7336,Fashion Victim,3346,3346,0,2010.csv,2010,100.0,0.0
7337,Swerve,3338,3338,0,2013.csv,2013,100.0,0.0
7338,Mi America,3330,3330,0,2015.csv,2015,100.0,0.0
7339,Know How,3323,3323,0,2015.csv,2015,100.0,0.0
7340,Drunk Wedding,3301,3301,0,2015.csv,2015,100.0,0.0
7341,Burning Bodhi,3289,3289,0,2016.csv,2016,100.0,0.0
7342,Axe Giant: The Wrath of Paul Bunyan,3287,3287,0,2013.csv,2013,100.0,0.0
7343,El Superstar: The Unlikely Rise of Juan Frances,3271,3271,0,2010.csv,2010,100.0,0.0
7344,Justice,3259,3259,0,2017.csv,2017,100.0,0.0
7345,Windsor Drive,3256,3256,0,2015.csv,2015,100.0,0.0
7346,Over the Limit,3243,3243,0,2018.csv,2018,100.0,0.0
7347,The Sons of Tennessee Williams,3242,3242,0,2011.csv,2011,100.0,0.0
7348,As Cool as I Am,3234,3234,0,2013.csv,2013,100.0,0.0
7349,Blackhats,3216,3216,0,2015.csv,2015,100.0,0.0
7350,After the Wizard,3184,3184,0,2012.csv,2012,100.0,0.0
7351,Apart,3161,3161,0,2012.csv,2012,100.0,0.0
7352,Game Changers,3142,3142,0,2018.csv,2018,100.0,0.0
7353,Balls to the Wall,3140,3140,0,2011.csv,2011,100.0,0.0
7354,Hot to Trot,3133,3133,0,2018.csv,2018,100.0,0.0
7355,The Girl on the Train,3124,3124,0,2014.csv,2014,100.0,0.0
7356,Showrunners,3100,3100,0,2014.csv,2014,100.0,0.0
7357,What Now? Remind Me,3089,3089,0,2014.csv,2014,100.0,0.0
7358,Drew: The Man Behind the Poster,3078,3078,0,2013.csv,2013,100.0,0.0
7359,Chasing Portraits,3076,3076,0,2019.csv,2019,100.0,0.0
7360,The Weird World of Blowfly,3062,3062,0,2011.csv,2011,100.0,0.0
7361,The Afterlight,3059,3059,0,2010.csv,2010,100.0,0.0
7362,A French Gigolo 2014 Re-release,3021,3021,0,2014.csv,2014,100.0,0.0
7363,A Girl and a Gun,3018,3018,0,2013.csv,2013,100.0,0.0
7364,Best and Most Beautiful Things,3016,3016,0,2016.csv,2016,100.0,0.0
7365,Zokkomon,3000,3000,0,2011.csv,2011,100.0,0.0
7366,The Lie,3000,3000,0,2011.csv,2011,100.0,0.0
7367,Fatal Assistance,3000,3000,0,2014.csv,2014,100.0,0.0
7368,The Ghosts of Johnson Woods,3000,3000,0,2016.csv,2016,100.0,0.0
7369,Moana,2993,2993,0,2015.csv,2015,100.0,0.0
7370,Kepler's Dream,2923,2923,0,2017.csv,2017,100.0,0.0
7371,Demons,2900,2900,0,2017.csv,2017,100.0,0.0
7372,The Professor: Tai Chi's Journey West,2852,2852,0,2016.csv,2016,100.0,0.0
7373,Approaching Midnight,2795,2795,0,2013.csv,2013,100.0,0.0
7374,Nana,2784,2784,0,2018.csv,2018,100.0,0.0
7375,White Lies 2016 Re-release,2760,2760,0,2016.csv,2016,100.0,0.0
7376,Blood Ties,2760,2760,0,2011.csv,2011,100.0,0.0
7377,I Dream in Another Language,2739,2739,0,2017.csv,2017,100.0,0.0
7378,Black Out 2014 Re-release,2734,2734,0,2014.csv,2014,100.0,0.0
7379,The Lesser Blessed,2732,2732,0,2013.csv,2013,100.0,0.0
7380,Julia,2710,2710,0,2015.csv,2015,100.0,0.0
7381,Chocolat 2015 Re-release,2710,2710,0,2015.csv,2015,100.0,0.0
7382,Adolf Eichmann,2706,2706,0,2010.csv,2010,100.0,0.0
7383,Back to the Fatherland,2697,2697,0,2019.csv,2019,100.0,0.0
7384,Straight Into a Storm,2684,2684,0,2018.csv,2018,100.0,0.0
7385,Santoalla,2684,2684,0,2017.csv,2017,100.0,0.0
7386,Division 19,2680,1699,981,2019.csv,2019,63.3955223880597,36.6044776119403
7387,Restitution,2664,2664,0,2011.csv,2011,100.0,0.0
7388,United Red Army 2011 Re-release,2659,2659,0,2011.csv,2011,100.0,0.0
7389,Bang! Bang!,2658,2658,0,2020.csv,2020,100.0,0.0
7390,Daughter of the Nile,2640,2640,0,2017.csv,2017,100.0,0.0
7391,Body,2634,2634,0,2015.csv,2015,100.0,0.0
7392,Refuge,2631,2631,0,2014.csv,2014,100.0,0.0
7393,ACORN and the Firestorm,2621,2621,0,2018.csv,2018,100.0,0.0
7394,Indigo Children,2621,2621,0,2014.csv,2014,100.0,0.0
7395,Sparrows Dance,2602,2602,0,2013.csv,2013,100.0,0.0
7396,Last Flight of the Champion,2597,2597,0,2013.csv,2013,100.0,0.0
7397,Jake Squared,2592,2592,0,2014.csv,2014,100.0,0.0
7398,Carl,2592,2592,0,2012.csv,2012,100.0,0.0
7399,Hammer of the Gods,2590,641,1949,2013.csv,2013,24.74903474903475,75.25096525096525
7400,Take Me,2583,2583,0,2017.csv,2017,100.0,0.0
7401,McCanick,2572,2572,0,2014.csv,2014,100.0,0.0
7402,Hayride 2,2571,2571,0,2015.csv,2015,100.0,0.0
7403,Joan the Maid 1: The Battles,2562,2562,0,2019.csv,2019,100.0,0.0
7404,Cassadaga,2544,2544,0,2013.csv,2013,100.0,0.0
7405,Two-Bit Waltz,2540,2540,0,2014.csv,2014,100.0,0.0
7406,Miles,2537,2537,0,2017.csv,2017,100.0,0.0
7407,Almost in Love,2510,2510,0,2013.csv,2013,100.0,0.0
7408,Mekong Hotel,2502,2502,0,2016.csv,2016,100.0,0.0
7409,The Last Day of August,2492,2492,0,2013.csv,2013,100.0,0.0
7410,Homeland (Iraq Year Zero),2491,2491,0,2016.csv,2016,100.0,0.0
7411,Men at Lunch,2483,2483,0,2013.csv,2013,100.0,0.0
7412,The Wait,2480,2480,0,2014.csv,2014,100.0,0.0
7413,TINY: The Life of Erin Blackwell,2465,2465,0,2019.csv,2019,100.0,0.0
7414,The Ghastly Love of Johnny X,2436,2436,0,2012.csv,2012,100.0,0.0
7415,Why Stop Now?,2432,2432,0,2012.csv,2012,100.0,0.0
7416,The Reflektor Tapes,2424,0,2424,2015.csv,2015,0.0,100.0
7417,L.A. Slasher,2421,2421,0,2015.csv,2015,100.0,0.0
7418,Ek Hazarachi Note,2404,2404,0,2016.csv,2016,100.0,0.0
7419,Daniel and Ana,2372,2372,0,2010.csv,2010,100.0,0.0
7420,Moondance,2371,2371,0,2020.csv,2020,100.0,0.0
7421,Evergreen: The Road to Legalization,2363,2363,0,2014.csv,2014,100.0,0.0
7422,I Lost Albert 2019 Re-release,2354,2354,0,2019.csv,2019,100.0,0.0
7423,A German Youth,2343,2343,0,2019.csv,2019,100.0,0.0
7424,Detective Chinatown 3,2342,0,2342,2020.csv,2020,0.0,100.0
7425,Lotus Eaters,2325,2325,0,2013.csv,2013,100.0,0.0
7426,The Happy House,2311,2311,0,2013.csv,2013,100.0,0.0
7427,Goldie,2302,2302,0,2020.csv,2020,100.0,0.0
7428,Serendipity,2298,2298,0,2019.csv,2019,100.0,0.0
7429,The Girl 2010 Re-release,2273,2201,72,2010.csv,2010,96.83238011438627,3.167619885613726
7430,The Pool Boys,2269,2269,0,2011.csv,2011,100.0,0.0
7431,Red Christmas,2255,2255,0,2017.csv,2017,100.0,0.0
7432,Anita Ho,2250,2250,0,2015.csv,2015,100.0,0.0
7433,Memoria,2242,2242,0,2016.csv,2016,100.0,0.0
7434,You Wont Miss Me,2240,2240,0,2010.csv,2010,100.0,0.0
7435,The Night Watchman,2219,2219,0,2012.csv,2012,100.0,0.0
7436,7 from Etheria,2208,2208,0,2017.csv,2017,100.0,0.0
7437,InSpectres,2207,2207,0,2013.csv,2013,100.0,0.0
7438,Scorn,2206,2206,0,2012.csv,2012,100.0,0.0
7439,NoBody's Perfect 2010 Re-release,2122,2122,0,2010.csv,2010,100.0,0.0
7440,Missionary,2120,2120,0,2014.csv,2014,100.0,0.0
7441,Me You and Five Bucks,2105,2105,0,2015.csv,2015,100.0,0.0
7442,Jihadists,2104,2104,0,2019.csv,2019,100.0,0.0
7443,Dayveon,2077,2077,0,2017.csv,2017,100.0,0.0
7444,Red Flag,2075,2075,0,2013.csv,2013,100.0,0.0
7445,Rubberneck,2075,2075,0,2013.csv,2013,100.0,0.0
7446,Patagonia Rising,2064,2064,0,2012.csv,2012,100.0,0.0
7447,The Transcendents,2041,2041,0,2020.csv,2020,100.0,0.0
7448,Gul Makai,2035,0,2035,2020.csv,2020,0.0,100.0
7449,Algorithms,2021,2021,0,2014.csv,2014,100.0,0.0
7450,Split: A Deeper Divide,2000,2000,0,2012.csv,2012,100.0,0.0
7451,The Watermelon Woman,1989,1989,0,2016.csv,2016,100.0,0.0
7452,Falling Awake,1978,1978,0,2010.csv,2010,100.0,0.0
7453,The Temptation of St. Tony,1963,1963,0,2010.csv,2010,100.0,0.0
7454,"Accidental Courtesy: Daryl Davis, Race & America",1940,1940,0,2017.csv,2017,100.0,0.0
7455,Best Man Down,1938,1938,0,2013.csv,2013,100.0,0.0
7456,West Of The Jordan River,1926,1926,0,2018.csv,2018,100.0,0.0
7457,A Mother's Courage: Talking Back to Autism 2010 Re-release,1916,1916,0,2010.csv,2010,100.0,0.0
7458,Sneakerheadz,1903,1903,0,2015.csv,2015,100.0,0.0
7459,We Were Here,1873,0,1873,2011.csv,2011,0.0,100.0
7460,Finding Happiness,1841,1841,0,2018.csv,2018,100.0,0.0
7461,Jimi Hendrix Electric Church,1818,0,1818,2019.csv,2019,0.0,100.0
7462,Now & Later,1808,1808,0,2011.csv,2011,100.0,0.0
7463,I Kissed a Vampire,1794,1794,0,2012.csv,2012,100.0,0.0
7464,Detour,1788,1788,0,2017.csv,2017,100.0,0.0
7465,The Shade Shepherd,1781,1781,0,2020.csv,2020,100.0,0.0
7466,The Lost Village,1780,1780,0,2018.csv,2018,100.0,0.0
7467,Detention of the Dead,1777,1777,0,2013.csv,2013,100.0,0.0
7468,The Other Man: F.W. de Klerk and the End of Apartheid,1747,1747,0,2015.csv,2015,100.0,0.0
7469,Dark Forest,1739,1739,0,2015.csv,2015,100.0,0.0
7470,You Don't Need Feet to Dance,1719,1719,0,2013.csv,2013,100.0,0.0
7471,A Beautiful Now,1714,1714,0,2016.csv,2016,100.0,0.0
7472,The Looking Glass,1711,1711,0,2015.csv,2015,100.0,0.0
7473,Dystopia: 2013,1708,1708,0,2012.csv,2012,100.0,0.0
7474,More Than the Rainbow,1677,1677,0,2014.csv,2014,100.0,0.0
7475,They're Out of the Business,1655,1655,0,2011.csv,2011,100.0,0.0
7476,Drown,1631,1631,0,2015.csv,2015,100.0,0.0
7477,Cut Snake,1625,1625,0,2015.csv,2015,100.0,0.0
7478,Game Day,1624,1624,0,2019.csv,2019,100.0,0.0
7479,Miss India America,1598,1598,0,2016.csv,2016,100.0,0.0
7480,Forever,1598,1598,0,2015.csv,2015,100.0,0.0
7481,American Playhouse: The Killing Floor,1583,1583,0,2019.csv,2019,100.0,0.0
7482,Manuela and Manuel,1582,1582,0,2010.csv,2010,100.0,0.0
7483,The Fox Hunter,1577,1577,0,2020.csv,2020,100.0,0.0
7484,The Tunnel,1532,1532,0,2011.csv,2011,100.0,0.0
7485,Rhymes for Young Ghouls,1529,1529,0,2014.csv,2014,100.0,0.0
7486,"Carmo, Hit the Road 2010 Re-release",1512,1512,0,2010.csv,2010,100.0,0.0
7487,Souldier,1500,1500,0,2014.csv,2014,100.0,0.0
7488,Where Are You Taking Me?,1492,1492,0,2012.csv,2012,100.0,0.0
7489,Making Rounds,1484,1484,0,2015.csv,2015,100.0,0.0
7490,Henchmen,1469,1469,0,2018.csv,2018,100.0,0.0
7491,The Package,1469,1469,0,2013.csv,2013,100.0,0.0
7492,That Way Madness Lies...,1447,1447,0,2018.csv,2018,100.0,0.0
7493,Bestiaire,1428,1428,0,2012.csv,2012,100.0,0.0
7494,The Silence of Mark Rothko,1422,1422,0,2016.csv,2016,100.0,0.0
7495,The Forest for the Trees,1410,1410,0,2017.csv,2017,100.0,0.0
7496,Drool,1403,1403,0,2010.csv,2010,100.0,0.0
7497,Beauty and the Beholder,1368,1368,0,2018.csv,2018,100.0,0.0
7498,Along the Roadside 2015 Re-release,1352,1352,0,2015.csv,2015,100.0,0.0
7499,3 Nights in the Desert,1297,1297,0,2015.csv,2015,100.0,0.0
7500,The Hours and Times,1273,1273,0,2019.csv,2019,100.0,0.0
7501,Altered Perception,1259,1259,0,2018.csv,2018,100.0,0.0
7502,The Wolf Hour,1255,0,1255,2019.csv,2019,0.0,100.0
7503,A Fish in the Bathtub 2019 re-release,1237,1237,0,2019.csv,2019,100.0,0.0
7504,Two Men Went to War 2018 Re-release,1227,1227,0,2018.csv,2018,100.0,0.0
7505,A Small Good Thing,1196,1196,0,2016.csv,2016,100.0,0.0
7506,Under the Turban,1190,1190,0,2018.csv,2018,100.0,0.0
7507,Snowman's Land,1190,1190,0,2012.csv,2012,100.0,0.0
7508,Above and Below,1189,0,1189,2016.csv,2016,0.0,100.0
7509,A Different American Dream,1172,1172,0,2017.csv,2017,100.0,0.0
7510,A Zombie Invasion,1170,1170,0,2013.csv,2013,100.0,0.0
7511,Fear Pharm,1157,1157,0,2020.csv,2020,100.0,0.0
7512,Jack & Diane,1142,1142,0,2012.csv,2012,100.0,0.0
7513,The Father,1141,0,1141,2020.csv,2020,0.0,100.0
7514,Veer!,1132,1132,0,2013.csv,2013,100.0,0.0
7515,Hai Tang Hong,1107,1107,0,2020.csv,2020,100.0,0.0
7516,Half Brothers,1100,1100,0,2018.csv,2018,100.0,0.0
7517,We Are the Giant,1088,1088,0,2014.csv,2014,100.0,0.0
7518,The Butterfly Room,1081,1081,0,2014.csv,2014,100.0,0.0
7519,Childless,1036,1036,0,2015.csv,2015,100.0,0.0
7520,Invisible Hands,1034,1034,0,2018.csv,2018,100.0,0.0
7521,Absence,1031,1031,0,2013.csv,2013,100.0,0.0
7522,Remnants,1022,1022,0,2013.csv,2013,100.0,0.0
7523,The Penguin Counters,976,976,0,2017.csv,2017,100.0,0.0
7524,Strangers Online,968,968,0,2011.csv,2011,100.0,0.0
7525,A People Uncounted,930,930,0,2014.csv,2014,100.0,0.0
7526,They Are We,900,900,0,2015.csv,2015,100.0,0.0
7527,Big Muddy,881,881,0,2015.csv,2015,100.0,0.0
7528,Extraordinary Ordinary People,880,880,0,2017.csv,2017,100.0,0.0
7529,45365,853,853,0,2010.csv,2010,100.0,0.0
7530,Officer Downe,850,850,0,2016.csv,2016,100.0,0.0
7531,Abandoned,832,832,0,2011.csv,2011,100.0,0.0
7532,TVTV: Video Revolutionaries,812,812,0,2018.csv,2018,100.0,0.0
7533,Jackpot 2014 Re-release,806,806,0,2014.csv,2014,100.0,0.0
7534,The Untold Story,790,790,0,2019.csv,2019,100.0,0.0
7535,It's All So Quiet 2015 Re-release,724,724,0,2015.csv,2015,100.0,0.0
7536,A Girl Like Grace,713,713,0,2016.csv,2016,100.0,0.0
7537,Redneck Carnage,706,706,0,2011.csv,2011,100.0,0.0
7538,The Loving Story,700,700,0,2012.csv,2012,100.0,0.0
7539,It's Hard Being Loved by Jerks 2015 Re-release,697,697,0,2015.csv,2015,100.0,0.0
7540,The Portal,685,0,685,2019.csv,2019,0.0,100.0
7541,Syrup,663,663,0,2013.csv,2013,100.0,0.0
7542,Nature Calls,646,646,0,2012.csv,2012,100.0,0.0
7543,Citizen Gangster,625,625,0,2012.csv,2012,100.0,0.0
7544,Gottfried Helnwein and the Dreaming Child,601,601,0,2012.csv,2012,100.0,0.0
7545,Shake Hands with the Devil,594,594,0,2010.csv,2010,100.0,0.0
7546,A Good Day to Die,573,573,0,2011.csv,2011,100.0,0.0
7547,The Pit,560,560,0,2016.csv,2016,100.0,0.0
7548,Higher Power,528,528,0,2018.csv,2018,100.0,0.0
7549,Greater 2020 Re-release,527,527,0,2020.csv,2020,100.0,0.0
7550,Meeting Evil,525,525,0,2012.csv,2012,100.0,0.0
7551,The 11th Hour,510,0,510,2015.csv,2015,0.0,100.0
7552,Triumph of the Wall,476,476,0,2013.csv,2013,100.0,0.0
7553,Green is Gold,455,455,0,2016.csv,2016,100.0,0.0
7554,The Magician 2010 Re-release,406,406,0,2010.csv,2010,100.0,0.0
7555,Skinless,400,400,0,2014.csv,2014,100.0,0.0
7556,Cinemanovels,398,398,0,2014.csv,2014,100.0,0.0
7557,Spaceship Earth,362,0,362,2020.csv,2020,0.0,100.0
7558,Antiporno,294,0,294,2017.csv,2017,0.0,100.0
7559,Wet Woman in the Wind,268,0,268,2017.csv,2017,0.0,100.0
7560,"Mummy, I'm A Zombie",120,120,0,2014.csv,2014,100.0,0.0
7561,Paranoid Girls,78,78,0,2015.csv,2015,100.0,0.0
7562,Confession of a Child of the Century 2015 Re-release,74,74,0,2015.csv,2015,100.0,0.0
